,exchange,all_premises,prem_under_2k,prem_over_2k,prem_under_1k,prem_over_1k,oslaua,oscty,gor,code,geotype_name,geotype_number,speed
0,CLBER,22880,22880,0,14567,8313,E09000023,E99999999,E12000007,00London,Inner London,1,50
1,CLBIS,9555,9555,0,8049,1506,E09000030,E99999999,E12000007,00London,Inner London,1,50
2,CLCAN,17385,17385,0,12005,5380,E09000012,E99999999,E12000007,00London,Inner London,1,50
3,CLCLE,15448,15448,0,13354,2094,E09000001,E99999999,E12000007,00London,Inner London,1,50
4,CLCOV,3204,3204,0,3204,0,E09000007,E99999999,E12000007,00London,Inner London,1,50
5,CLEUS,7006,7006,0,5913,1093,E09000007,E99999999,E12000007,00London,Inner London,1,50
6,CLFAR,779,779,0,779,0,E09000028,E99999999,E12000007,00London,Inner London,1,50
7,CLFLE,2744,2744,0,2744,0,E09000001,E99999999,E12000007,00London,Inner London,1,50
8,CLHOL,5305,5305,0,5305,0,E09000001,E99999999,E12000007,00London,Inner London,1,50
9,CLKEN,27860,27581,279,16901,10959,E09000019,E99999999,E12000007,00London,Inner London,1,50
10,CLKLG,22718,22718,0,16789,5929,E09000012,E99999999,E12000007,00London,Inner London,1,50
11,CLKXX,9080,9080,0,8644,436,E09000019,E99999999,E12000007,00London,Inner London,1,50
12,CLLOW,16246,16246,0,13605,2641,E09000019,E99999999,E12000007,00London,Inner London,1,50
13,CLMON,2257,2257,0,2254,3,E09000028,E99999999,E12000007,00London,Inner London,1,50
14,CLMOO,3150,3150,0,3150,0,E09000001,E99999999,E12000007,00London,Inner London,1,50
15,CLNEW,32755,32755,0,15439,17316,E09000023,E99999999,E12000007,00London,Inner London,1,50
16,CLSHO,16013,16013,0,11337,4676,E09000030,E99999999,E12000007,00London,Inner London,1,50
17,CLSOU,10957,10957,0,10869,88,E09000028,E99999999,E12000007,00London,Inner London,1,50
18,CLSTE,18430,18430,0,14425,4005,E09000028,E99999999,E12000007,00London,Inner London,1,50
19,CLUPP,26102,25811,291,16411,9691,E09000012,E99999999,E12000007,00London,Inner London,1,50
20,CLWAL,20419,20419,0,13031,7388,E09000028,E99999999,E12000007,00London,Inner London,1,50
21,CLWAP,8829,8829,0,7665,1164,E09000028,E99999999,E12000007,00London,Inner London,1,50
22,CMACK,335,253,82,138,197,E07000196,E10000028,E12000005,41,"Below 1,000 (b)",13,10
23,CMACO,24542,21403,3139,7861,16681,E08000025,E99999999,E12000005,00CN,Large City,2,50
24,CMALB,2867,2577,290,2024,843,E07000196,E10000028,E12000005,41,"Above 1,000 (b)",11,10
25,CMALC,4207,3844,363,2732,1475,E07000221,E10000031,E12000005,44,"Above 3,000 (a)",8,30
26,CMALD,8225,8000,225,3392,4833,E08000030,E99999999,E12000005,00CU,"Above 3,000 (b)",9,10
27,CMALDM,720,269,451,155,565,E07000221,E10000031,E12000005,44,"Below 1,000 (b)",13,10
28,CMALL,8007,7668,339,2904,5103,E08000029,E99999999,E12000005,00CT,"Above 3,000 (b)",9,10
29,CMARM,3825,3108,717,1704,2121,E07000194,E10000028,E12000005,41,"Above 3,000 (b)",9,10
30,CMASHF,9454,8237,1217,3677,5777,E08000025,E99999999,E12000005,00CN,"Above 3,000 (b)",9,10
31,CMASTX,3948,3948,0,1733,2215,E08000025,E99999999,E12000005,00CN,"Above 3,000 (b)",9,10
32,CMBARF,1595,751,844,612,983,E07000221,E10000031,E12000005,44,"Above 1,000 (b)",11,10
33,CMBEAC,22823,11824,10999,2671,20152,E08000025,E99999999,E12000005,00CN,Large City,2,50
34,CMBEAR,15281,14551,730,7677,7604,E08000025,E99999999,E12000005,00CN,Large City,2,50
35,CMBED,11447,8382,3065,5955,5492,E07000219,E10000031,E12000005,44,"Above 10,000 (b)",7,30
36,CMBER,3533,3207,326,2516,1017,E08000029,E99999999,E12000005,00CT,"Above 3,000 (b)",9,10
37,CMBIDF,3632,2826,806,1241,2391,E07000221,E10000031,E12000005,44,"Above 3,000 (b)",9,10
38,CMBIL,17961,15316,2645,4325,13636,E08000028,E99999999,E12000005,00CS,Large City,2,50
39,CMBIN,16247,15495,752,5845,10402,E08000026,E99999999,E12000005,00CQ,Small City,3,50
40,CMBIR,15985,12734,3251,7244,8741,E08000025,E99999999,E12000005,00CN,Large City,2,50
41,CMBKN,288,115,173,9,279,E06000051,E99999999,E12000005,00GG,"Below 1,000 (b)",13,10
42,CMBLAC,18812,17742,1070,7244,11568,E08000028,E99999999,E12000005,00CS,Large City,2,50
43,CMBNW,13701,11947,1754,5499,8202,E07000194,E10000028,E12000005,41,"Above 10,000 (b)",7,30
44,CMBOB,500,271,229,119,381,E07000196,E10000028,E12000005,41,"Below 1,000 (b)",13,10
45,CMBRAU,2645,845,1800,781,1864,E07000221,E10000031,E12000005,44,"Above 1,000 (b)",11,10
46,CMBRE,1547,1372,175,1133,414,E07000196,E10000028,E12000005,41,"Above 1,000 (b)",11,10
47,CMBRI,7230,6709,521,3874,3356,E06000051,E99999999,E12000005,00GG,"Above 3,000 (a)",8,30
48,CMBRO,12450,10506,1944,1768,10682,E08000028,E99999999,E12000005,00CS,Large City,2,50
49,CMBRU,10286,8322,1964,3687,6599,E08000030,E99999999,E12000005,00CU,Large City,2,50
50,CMBWN,184,106,78,56,128,E06000051,E99999999,E12000005,00GG,"Below 1,000 (b)",13,10
51,CMBYL,15135,13961,1174,4057,11078,E08000027,E99999999,E12000005,00CR,Large City,2,50
52,CMCAL,8257,8257,0,5672,2585,E08000025,E99999999,E12000005,00CN,"Above 3,000 (b)",9,10
53,CMCAN,12701,11510,1191,5013,7688,E07000196,E10000028,E12000005,41,"Above 10,000 (b)",7,30
54,CMCAS,24685,20296,4389,5759,18926,E08000025,E99999999,E12000005,00CN,Large City,2,50
55,CMCEN,5848,5848,0,5297,551,E08000025,E99999999,E12000005,00CN,"Above 3,000 (a)",8,30
56,CMCGF,9537,9537,0,4312,5225,E08000026,E99999999,E12000005,00CQ,Small City,3,50
57,CMCHAP,13243,10243,3000,4173,9070,E07000218,E10000031,E12000005,44,"Above 10,000 (b)",7,30
58,CMCHEL,19440,18248,1192,7128,12312,E08000025,E99999999,E12000005,00CN,Large City,2,50
59,CMCHEY,6007,6007,0,5438,569,E08000026,E99999999,E12000005,00CQ,"Above 3,000 (b)",9,10
60,CMCHY,9483,8672,811,3807,5676,E07000196,E10000028,E12000005,41,"Above 3,000 (b)",9,10
61,CMCLA,706,472,234,345,361,E07000196,E10000028,E12000005,41,"Below 1,000 (b)",13,10
62,CMCLAV,1216,578,638,368,848,E07000221,E10000031,E12000005,44,"Above 1,000 (b)",11,10
63,CMCOD,6576,5408,1168,3793,2783,E07000196,E10000028,E12000005,41,"Above 3,000 (b)",9,10
64,CMCOLE,3766,3543,223,2224,1542,E08000029,E99999999,E12000005,00CT,"Above 3,000 (b)",9,10
65,CMCRA,18530,17074,1456,5956,12574,E08000028,E99999999,E12000005,00CS,Large City,2,50
66,CMCRI,1977,893,1084,831,1146,E07000220,E10000031,E12000005,44,"Above 1,000 (b)",11,10
67,CMCUR,2696,1939,757,498,2198,E08000025,E99999999,E12000005,00CN,"Above 1,000 (b)",11,10
68,CMDD,23357,18952,4405,4535,18822,E08000028,E99999999,E12000005,00CS,Large City,2,50
69,CMDIT,515,283,232,238,277,E06000051,E99999999,E12000005,00GG,"Below 1,000 (b)",13,10
70,CMDRU,13062,12615,447,5727,7335,E08000025,E99999999,E12000005,00CN,Large City,2,50
71,CMDUN,8405,5506,2899,1753,6652,E07000220,E10000031,E12000005,44,"Above 3,000 (b)",9,10
72,CMEARD,10039,9519,520,7741,2298,E08000026,E99999999,E12000005,00CQ,Small City,3,50
73,CMEARL,4923,3491,1432,945,3978,E08000029,E99999999,E12000005,00CT,"Above 3,000 (a)",8,30
74,CMEAS,12582,10359,2223,3229,9353,E08000025,E99999999,E12000005,00CN,Large City,2,50
75,CMEDG,9260,9260,0,6211,3049,E08000025,E99999999,E12000005,00CN,"Above 3,000 (a)",8,30
76,CMELMD,1546,1474,72,378,1168,E08000029,E99999999,E12000005,00CT,"Above 1,000 (a)",10,10
77,CMERD,36227,26968,9259,8544,27683,E08000025,E99999999,E12000005,00CN,Large City,2,50
78,CMETT,860,477,383,434,426,E07000221,E10000031,E12000005,44,"Below 1,000 (b)",13,10
79,CMEXH,11671,10176,1495,2985,8686,E07000218,E10000031,E12000005,44,"Above 10,000 (b)",7,30
80,CMFAL,21041,16055,4986,6181,14860,E07000196,E10000028,E12000005,41,"Above 20,000 (b)",5,30
81,CMFIL,2334,644,1690,324,2010,E08000029,E99999999,E12000005,00CT,"Above 1,000 (b)",11,10
82,CMFIN,12968,9165,3803,3541,9427,E07000196,E10000028,E12000005,41,"Above 10,000 (a)",6,30
83,CMFOL,21205,19457,1748,6570,14635,E08000026,E99999999,E12000005,00CQ,Small City,3,50
84,CMFOR,14347,11708,2639,5469,8878,E07000196,E10000028,E12000005,41,"Above 10,000 (b)",7,30
85,CMFOU,11217,9572,1645,4355,6862,E08000025,E99999999,E12000005,00CN,Large City,2,50
86,CMFRA,1108,830,278,57,1051,E07000194,E10000028,E12000005,41,"Above 1,000 (b)",11,10
87,CMFUR,914,452,462,148,766,E07000218,E10000031,E12000005,44,"Below 1,000 (b)",13,10
88,CMGREA,1054,352,702,151,903,E07000221,E10000031,E12000005,44,"Above 1,000 (b)",11,10
89,CMGREB,12414,9669,2745,4066,8348,E08000025,E99999999,E12000005,00CN,Large City,2,50
90,CMHALE,13379,11157,2222,4303,9076,E08000025,E99999999,E12000005,00CN,Large City,2,50
91,CMHAMP,1343,1012,331,444,899,E08000029,E99999999,E12000005,00CT,"Above 1,000 (b)",11,10
92,CMHARBO,17136,15102,2034,6635,10501,E08000025,E99999999,E12000005,00CN,Large City,2,50
93,CMHARBU,2346,1103,1243,1012,1334,E07000221,E10000031,E12000005,44,"Above 1,000 (b)",11,10
94,CMHASN,895,344,551,96,799,E08000029,E99999999,E12000005,00CT,"Below 1,000 (b)",13,10
95,CMHEA,8047,6099,1948,2566,5481,E07000194,E10000028,E12000005,41,"Above 3,000 (b)",9,10
96,CMHED,13634,11408,2226,4278,9356,E07000196,E10000028,E12000005,41,"Above 10,000 (b)",7,30
97,CMHEN,2759,1883,876,1670,1089,E07000221,E10000031,E12000005,44,"Above 1,000 (b)",11,10
98,CMHIG,2697,1797,900,1402,1295,E06000051,E99999999,E12000005,00GG,"Above 1,000 (b)",11,10
99,CMHIGH,15058,13898,1160,6474,8584,E08000025,E99999999,E12000005,00CN,Large City,2,50
100,CMHIGW,7055,6039,1016,4223,2832,E08000026,E99999999,E12000005,00CQ,Small City,3,50
101,CMHILL,6009,2995,3014,925,5084,E07000234,E10000034,E12000005,47,"Above 3,000 (b)",9,10
102,CMHOR,11157,10075,1082,3375,7782,E08000031,E99999999,E12000005,00CW,Large City,2,50
103,CMJAM,10421,9935,486,5672,4749,E08000028,E99999999,E12000005,00CS,Large City,2,50
104,CMKEN,11453,10068,1385,5046,6407,E07000222,E10000031,E12000005,44,"Above 10,000 (b)",7,30
105,CMKER,12986,11318,1668,5658,7328,E07000218,E10000031,E12000005,44,"Above 10,000 (b)",7,30
106,CMKINE,1643,1275,368,886,757,E07000221,E10000031,E12000005,44,"Above 1,000 (b)",11,10
107,CMKING,18064,14823,3241,4856,13208,E08000025,E99999999,E12000005,00CN,Large City,2,50
108,CMKNO,9073,7965,1108,3408,5665,E08000029,E99999999,E12000005,00CT,"Above 3,000 (b)",9,10
109,CMKVR,2998,2572,426,1376,1622,E07000239,E10000034,E12000005,47,"Above 1,000 (b)",11,10
110,CMKWD,17350,14629,2721,5381,11969,E08000027,E99999999,E12000005,00CR,Large City,2,50
111,CMLAP,1852,643,1209,375,1477,E08000029,E99999999,E12000005,00CT,"Above 1,000 (b)",11,10
112,CMLEA,25991,19408,6583,6449,19542,E08000030,E99999999,E12000005,00CU,Large City,2,50
113,CMLGS,32231,20233,11998,8502,23729,E07000222,E10000031,E12000005,44,"Above 20,000 (b)",5,30
114,CMLIC,15438,14377,1061,5255,10183,E07000194,E10000028,E12000005,41,"Above 10,000 (a)",6,30
115,CMLYE,11604,11478,126,4632,6972,E07000234,E10000034,E12000005,47,"Above 10,000 (b)",7,30
116,CMMART,1505,484,1021,187,1318,E07000221,E10000031,E12000005,44,"Above 1,000 (b)",11,10
117,CMMER,1621,1152,469,1011,610,E08000029,E99999999,E12000005,00CT,"Above 1,000 (b)",11,10
118,CMMID,269,86,183,35,234,E06000051,E99999999,E12000005,00GG,"Below 1,000 (b)",13,10
119,CMMLD,1886,1886,0,1886,0,E08000025,E99999999,E12000005,00CN,"Above 1,000 (a)",10,10
120,CMMOR,379,110,269,54,325,E06000051,E99999999,E12000005,00GG,"Below 1,000 (b)",13,10
121,CMMORT,1036,459,577,212,824,E07000221,E10000031,E12000005,44,"Above 1,000 (b)",11,10
122,CMNOR,17156,16107,1049,8241,8915,E08000025,E99999999,E12000005,00CN,Large City,2,50
123,CMNUN,26705,18387,8318,6765,19940,E07000219,E10000031,E12000005,44,"Above 20,000 (a)",4,30
124,CMPAI,1244,414,830,224,1020,E07000220,E10000031,E12000005,44,"Above 1,000 (b)",11,10
125,CMPAT,1217,937,280,790,427,E07000196,E10000028,E12000005,41,"Above 1,000 (b)",11,10
126,CMPEB,1693,1241,452,511,1182,E07000221,E10000031,E12000005,44,"Above 1,000 (b)",11,10
127,CMPEL,11365,10822,543,3736,7629,E08000030,E99999999,E12000005,00CU,Large City,2,50
128,CMPEN,16112,14948,1164,6790,9322,E08000027,E99999999,E12000005,00CR,Large City,2,50
129,CMPRI,27942,20118,7824,6002,21940,E08000025,E99999999,E12000005,00CN,Large City,2,50
130,CMQUA,559,184,375,60,499,E06000051,E99999999,E12000005,00GG,"Below 1,000 (b)",13,10
131,CMRAD,12221,12171,50,7269,4952,E08000026,E99999999,E12000005,00CQ,Small City,3,50
132,CMREC,7697,7415,282,4159,3538,E08000025,E99999999,E12000005,00CN,"Above 3,000 (a)",8,30
133,CMRUB,16594,14169,2425,5983,10611,E08000025,E99999999,E12000005,00CN,Large City,2,50
134,CMRUGB,29703,17428,12275,7601,22102,E07000220,E10000031,E12000005,44,"Above 20,000 (a)",4,30
135,CMSED,24927,18476,6451,4858,20069,E08000027,E99999999,E12000005,00CR,Large City,2,50
136,CMSEL,10130,9888,242,4123,6007,E08000025,E99999999,E12000005,00CN,"Above 10,000 (a)",6,30
137,CMSFD,2436,1582,854,1271,1165,E07000196,E10000028,E12000005,41,"Above 1,000 (b)",11,10
138,CMSHE,1606,1120,486,1002,604,E07000194,E10000028,E12000005,41,"Above 1,000 (b)",11,10
139,CMSHEL,20857,19391,1466,6330,14527,E08000025,E99999999,E12000005,00CN,Large City,2,50
140,CMSHI,24981,21553,3428,6347,18634,E08000025,E99999999,E12000005,00CN,Large City,2,50
141,CMSMBK,3035,3035,0,2965,70,E08000025,E99999999,E12000005,00CN,"Above 3,000 (a)",8,30
142,CMSME,17664,16864,800,5186,12478,E08000025,E99999999,E12000005,00CN,Large City,2,50
143,CMSNI,1239,574,665,451,788,E07000221,E10000031,E12000005,44,"Above 1,000 (b)",11,10
144,CMSOL,16509,12485,4024,3722,12787,E08000029,E99999999,E12000005,00CT,Large City,2,50
145,CMSON,393,188,205,89,304,E06000051,E99999999,E12000005,00GG,"Below 1,000 (b)",13,10
146,CMSOUB,16768,13504,3264,5786,10982,E08000025,E99999999,E12000005,00CN,Large City,2,50
147,CMSOUC,5240,3073,2167,2874,2366,E07000221,E10000031,E12000005,44,"Above 3,000 (b)",9,10
148,CMSTB,21515,18144,3371,6599,14916,E08000027,E99999999,E12000005,00CR,Large City,2,50
149,CMSTE,31066,24335,6731,6638,24428,E08000025,E99999999,E12000005,00CN,Large City,2,50
150,CMSTOX,12475,11128,1347,5226,7249,E08000025,E99999999,E12000005,00CN,Large City,2,50
151,CMSTRA,15287,12343,2944,4541,10746,E07000221,E10000031,E12000005,44,"Above 10,000 (a)",6,30
152,CMSTRE,8970,7022,1948,2524,6446,E08000025,E99999999,E12000005,00CN,"Above 3,000 (b)",9,10
153,CMSUT,10074,6352,3722,3580,6494,E08000025,E99999999,E12000005,00CN,"Above 10,000 (b)",7,30
154,CMSWI,1062,345,717,91,971,E07000220,E10000031,E12000005,44,"Above 1,000 (b)",11,10
155,CMTAN,1054,655,399,284,770,E07000234,E10000034,E12000005,47,"Above 1,000 (b)",11,10
156,CMTET,12856,11544,1312,5465,7391,E07000196,E10000028,E12000005,41,"Above 10,000 (b)",7,30
157,CMTIL,13772,12317,1455,3861,9911,E08000029,E99999999,E12000005,00CT,Large City,2,50
158,CMTIP,20315,17594,2721,5572,14743,E08000028,E99999999,E12000005,00CS,Large City,2,50
159,CMTOL,6800,6026,774,3984,2816,E08000026,E99999999,E12000005,00CQ,Small City,3,50
160,CMVIC,18139,14243,3896,3981,14158,E08000025,E99999999,E12000005,00CN,Large City,2,50
161,CMWAL,16562,14393,2169,5205,11357,E08000026,E99999999,E12000005,00CQ,Small City,3,50
162,CMWARW,14483,11700,2783,5353,9130,E07000222,E10000031,E12000005,44,"Above 10,000 (b)",7,30
163,CMWDGT,21433,16625,4808,6425,15008,E08000025,E99999999,E12000005,00CN,Large City,2,50
164,CMWED,12130,11659,471,4578,7552,E08000028,E99999999,E12000005,00CS,Large City,2,50
165,CMWEE,3283,2817,466,1976,1307,E07000221,E10000031,E12000005,44,"Above 3,000 (b)",9,10
166,CMWEL,1280,713,567,563,717,E07000221,E10000031,E12000005,44,"Above 1,000 (b)",11,10
167,CMWESB,12443,12443,0,6866,5577,E08000028,E99999999,E12000005,00CS,Large City,2,50
168,CMWESH,729,672,57,635,94,E07000151,E10000021,E12000004,34,"Below 1,000 (b)",13,10
169,CMWHY,1632,1198,434,930,702,E07000194,E10000028,E12000005,41,"Above 1,000 (b)",11,10
170,CMWIL,22038,15690,6348,5260,16778,E08000030,E99999999,E12000005,00CU,Large City,2,50
171,CMWL,27247,21930,5317,7446,19801,E08000028,E99999999,E12000005,00CS,Large City,2,50
172,CMWOL,3753,1470,2283,1267,2486,E07000220,E10000031,E12000005,44,"Above 3,000 (b)",9,10
173,CMWOM,7477,6161,1316,3064,4413,E08000027,E99999999,E12000005,00CR,"Above 3,000 (b)",9,10
174,CMWOR,513,357,156,123,390,E06000051,E99999999,E12000005,00GG,"Below 1,000 (b)",13,10
175,CMWV,6818,6818,0,4474,2344,E08000031,E99999999,E12000005,00CW,"Above 3,000 (a)",8,30
176,CMWYT,3673,3246,427,658,3015,E08000029,E99999999,E12000005,00CT,"Above 3,000 (b)",9,10
177,CMYOX,1304,895,409,396,908,E07000194,E10000028,E12000005,41,"Above 1,000 (b)",11,10
178,EAABR,2494,2103,391,1766,728,E07000205,E10000029,E12000006,42,"Above 1,000 (b)",11,10
179,EAABY,681,238,443,40,641,E07000149,E10000020,E12000006,33,"Below 1,000 (b)",13,10
180,EAACL,2088,1440,648,1222,866,E07000144,E10000020,E12000006,33,"Above 1,000 (a)",10,10
181,EAALB,803,452,351,84,719,E07000242,E10000015,E12000006,26,"Below 1,000 (b)",13,10
182,EAARD,1265,746,519,411,854,E07000071,E10000012,E12000006,22,"Above 1,000 (b)",11,10
183,EAARR,1337,273,1064,88,1249,E07000012,E10000003,E12000006,12,"Above 1,000 (b)",11,10
184,EAASD,966,281,685,62,904,E07000012,E10000003,E12000006,12,"Below 1,000 (a)",12,10
185,EAASW,1122,289,833,69,1053,E07000146,E10000020,E12000006,33,"Above 1,000 (b)",11,10
186,EAATT,6353,5373,980,3856,2497,E07000149,E10000020,E12000006,33,"Above 3,000 (b)",9,10
187,EAAYL,4037,3298,739,2741,1296,E07000144,E10000020,E12000006,33,"Above 3,000 (b)",9,10
188,EABAC,1592,851,741,421,1171,E07000203,E10000029,E12000006,42,"Above 1,000 (b)",11,10
189,EABAD,517,226,291,135,382,E07000203,E10000029,E12000006,42,"Below 1,000 (b)",13,10
190,EABAS,14320,13042,1278,6969,7351,E07000066,E10000012,E12000006,22,"Above 10,000 (b)",7,30
191,EABAW,1198,515,683,394,804,E07000143,E10000020,E12000006,33,"Above 1,000 (b)",11,10
192,EABBY,1102,709,393,76,1026,E07000206,E10000029,E12000006,42,"Above 1,000 (b)",11,10
193,EABCY,14544,12455,2089,4588,9956,E07000066,E10000012,E12000006,22,"Above 10,000 (a)",6,30
194,EABDC,245,109,136,8,237,E07000009,E10000003,E12000006,12,"Below 1,000 (b)",13,10
195,EABDF,369,274,95,44,325,E07000099,E10000015,E12000006,26,"Below 1,000 (b)",13,10
196,EABEC,7322,6137,1185,3627,3695,E07000206,E10000029,E12000006,42,"Above 3,000 (a)",8,30
197,EABEL,11899,11727,172,5409,6490,E07000200,E10000029,E12000006,42,"Above 10,000 (b)",7,30
198,EABEY,1657,683,974,298,1359,E07000204,E10000029,E12000006,42,"Above 1,000 (b)",11,10
199,EABFN,156,62,94,7,149,E07000009,E10000003,E12000006,12,"Below 1,000 (a)",12,10
200,EABGC,3438,2798,640,1677,1761,E07000206,E10000029,E12000006,42,"Above 3,000 (b)",9,10
201,EABGY,3946,3668,278,2099,1847,E07000206,E10000029,E12000006,42,"Above 3,000 (a)",8,30
202,EABIL,2050,603,1447,509,1541,E07000200,E10000029,E12000006,42,"Above 1,000 (b)",11,10
203,EABIN,920,240,680,163,757,E07000147,E10000020,E12000006,33,"Below 1,000 (a)",12,10
204,EABIR,558,422,136,108,450,E07000071,E10000012,E12000006,22,"Below 1,000 (b)",13,10
205,EABIS,17072,14426,2646,6567,10505,E07000242,E10000015,E12000006,26,"Above 10,000 (b)",7,30
206,EABKW,936,382,554,286,650,E07000099,E10000015,E12000006,26,"Below 1,000 (b)",13,10
207,EABLA,3645,2594,1051,768,2877,E07000072,E10000012,E12000006,22,"Above 3,000 (a)",8,30
208,EABLU,6995,4340,2655,733,6262,E07000206,E10000029,E12000006,42,"Above 3,000 (b)",9,10
209,EABLY,685,206,479,139,546,E07000205,E10000029,E12000006,42,"Below 1,000 (b)",13,10
210,EABMD,6848,6032,816,2285,4563,E07000070,E10000012,E12000006,22,"Above 3,000 (b)",9,10
211,EABMF,386,192,194,12,374,E07000205,E10000029,E12000006,42,"Below 1,000 (b)",13,10
212,EABMK,1210,947,263,661,549,E07000146,E10000020,E12000006,33,"Above 1,000 (b)",11,10
213,EABNC,849,521,328,406,443,E07000146,E10000020,E12000006,33,"Below 1,000 (a)",12,10
214,EABND,5584,4552,1032,2808,2776,E07000201,E10000029,E12000006,42,"Above 3,000 (a)",8,30
215,EABNH,4036,3878,158,3210,826,E07000074,E10000012,E12000006,22,"Above 3,000 (b)",9,10
216,EABNM,713,318,395,103,610,E07000149,E10000020,E12000006,33,"Below 1,000 (b)",13,10
217,EABNT,24931,17420,7511,7238,17693,E07000077,E10000012,E12000006,22,"Above 20,000 (b)",5,30
218,EABNW,978,575,403,292,686,E07000149,E10000020,E12000006,33,"Below 1,000 (a)",12,10
219,EABOR,10817,9373,1444,2990,7827,E07000070,E10000012,E12000006,22,"Above 10,000 (a)",6,30
220,EABOT,1650,1025,625,647,1003,E07000204,E10000029,E12000006,42,"Above 1,000 (b)",11,10
221,EABRD,556,339,217,201,355,E07000074,E10000012,E12000006,22,"Below 1,000 (b)",13,10
222,EABRI,4878,4536,342,3355,1523,E07000071,E10000012,E12000006,22,"Above 3,000 (b)",9,10
223,EABRK,1161,724,437,543,618,E07000149,E10000020,E12000006,33,"Above 1,000 (b)",11,10
224,EABRP,671,178,493,49,622,E07000242,E10000015,E12000006,26,"Below 1,000 (b)",13,10
225,EABRR,1427,891,536,777,650,E07000204,E10000029,E12000006,42,"Above 1,000 (b)",11,10
226,EABRT,621,250,371,39,582,E07000206,E10000029,E12000006,42,"Below 1,000 (b)",13,10
227,EABRU,5020,3093,1927,1139,3881,E07000149,E10000020,E12000006,33,"Above 3,000 (b)",9,10
228,EABRW,22406,14452,7954,5919,16487,E07000068,E10000012,E12000006,22,"Above 20,000 (b)",5,30
229,EABSE,19607,13818,5789,6366,13241,E07000204,E10000029,E12000006,42,"Above 10,000 (b)",7,30
230,EABSM,887,179,708,55,832,E07000203,E10000029,E12000006,42,"Below 1,000 (b)",13,10
231,EABTF,2864,2679,185,2503,361,E07000242,E10000015,E12000006,26,"Above 1,000 (b)",11,10
232,EABTM,2033,1277,756,880,1153,E07000012,E10000003,E12000006,12,"Above 1,000 (b)",11,10
233,EABUR,1233,799,434,692,541,E07000067,E10000012,E12000006,22,"Above 1,000 (b)",11,10
234,EABUX,1054,715,339,512,542,E07000144,E10000020,E12000006,33,"Above 1,000 (b)",11,10
235,EABWL,3320,2774,546,2281,1039,E07000009,E10000003,E12000006,12,"Above 3,000 (a)",8,30
236,EABYF,1261,426,835,97,1164,E07000241,E10000015,E12000006,26,"Above 1,000 (b)",11,10
237,EACAA,810,463,347,431,379,E07000146,E10000020,E12000006,33,"Below 1,000 (b)",13,10
238,EACAI,4548,4512,36,3194,1354,E07000145,E10000020,E12000006,33,"Above 3,000 (b)",9,10
239,EACAM,12155,12114,41,4230,7925,E07000008,E10000003,E12000006,12,"Above 10,000 (a)",6,30
240,EACAR,1591,1456,135,95,1496,E07000146,E10000020,E12000006,33,"Above 1,000 (b)",11,10
241,EACAX,4899,2173,2726,193,4706,E07000012,E10000003,E12000006,12,"Above 3,000 (b)",9,10
242,EACDN,887,560,327,88,799,E07000074,E10000012,E12000006,22,"Below 1,000 (b)",13,10
243,EACFD,1004,340,664,101,903,E07000204,E10000029,E12000006,42,"Above 1,000 (b)",11,10
244,EACFH,2468,2167,301,1844,624,E07000012,E10000003,E12000006,12,"Above 1,000 (a)",10,10
245,EACHA,600,238,362,126,474,E07000205,E10000029,E12000006,42,"Below 1,000 (b)",13,10
246,EACHE,22214,19713,2501,7134,15080,E07000070,E10000012,E12000006,22,"Above 20,000 (a)",4,30
247,EACHF,11660,10580,1080,4723,6937,E06000034,E99999999,E12000006,00KG,"Above 10,000 (a)",6,30
248,EACHR,948,453,495,162,786,E07000099,E10000015,E12000006,26,"Below 1,000 (b)",13,10
249,EACHT,848,589,259,224,624,E07000204,E10000029,E12000006,42,"Below 1,000 (b)",13,10
250,EACHU,16140,12546,3594,5311,10829,E07000072,E10000012,E12000006,22,"Above 10,000 (b)",7,30
251,EACHY,1204,762,442,326,878,E07000009,E10000003,E12000006,12,"Above 1,000 (b)",11,10
252,EACLA,1477,1149,328,893,584,E07000067,E10000012,E12000006,22,"Above 1,000 (b)",11,10
253,EACLE,1458,1138,320,416,1042,E07000147,E10000020,E12000006,33,"Above 1,000 (b)",11,10
254,EACLN,19509,13718,5791,5917,13592,E07000076,E10000012,E12000006,22,"Above 10,000 (a)",6,30
255,EACLV,863,635,228,210,653,E07000077,E10000012,E12000006,22,"Below 1,000 (b)",13,10
256,EACLY,2792,2382,410,1395,1397,E07000203,E10000029,E12000006,42,"Above 1,000 (b)",11,10
257,EACOD,539,326,213,219,320,E07000203,E10000029,E12000006,42,"Below 1,000 (b)",13,10
258,EACOG,2468,2238,230,1834,634,E07000067,E10000012,E12000006,22,"Above 1,000 (b)",11,10
259,EACOL,16417,11198,5219,5367,11050,E07000071,E10000012,E12000006,22,"Above 10,000 (a)",6,30
260,EACOM,2210,1114,1096,937,1273,E07000012,E10000003,E12000006,12,"Above 1,000 (b)",11,10
261,EACOP,770,623,147,194,576,E07000200,E10000029,E12000006,42,"Below 1,000 (b)",13,10
262,EACOS,12941,10869,2072,4431,8510,E07000149,E10000020,E12000006,33,"Above 10,000 (b)",7,30
263,EACOX,2619,2430,189,478,2141,E07000068,E10000012,E12000006,22,"Above 1,000 (b)",11,10
264,EACRH,17612,15966,1646,8703,8909,E07000008,E10000003,E12000006,12,"Above 10,000 (a)",6,30
265,EACRO,5083,4879,204,3137,1946,E07000147,E10000020,E12000006,33,"Above 3,000 (b)",9,10
266,EACST,999,315,684,110,889,E07000143,E10000020,E12000006,33,"Below 1,000 (b)",13,10
267,EACTD,374,295,79,201,173,E07000099,E10000015,E12000006,26,"Below 1,000 (b)",13,10
268,EACTM,2858,2558,300,2295,563,E07000012,E10000003,E12000006,12,"Above 1,000 (a)",10,10
269,EACTP,1915,1310,605,914,1001,E07000012,E10000003,E12000006,12,"Above 1,000 (b)",11,10
270,EACTS,1718,1206,512,972,746,E07000144,E10000020,E12000006,33,"Above 1,000 (b)",11,10
271,EACUL,1471,423,1048,134,1337,E07000204,E10000029,E12000006,42,"Above 1,000 (b)",11,10
272,EACVI,16757,15140,1617,6127,10630,E06000035,E99999999,E12000008,00LC,Small City,3,50
273,EACWT,798,496,302,157,641,E07000204,E10000029,E12000006,42,"Below 1,000 (b)",13,10
274,EADAN,4261,2590,1671,1546,2715,E07000074,E10000012,E12000006,22,"Above 3,000 (b)",9,10
275,EADEB,1365,1067,298,261,1104,E07000203,E10000029,E12000006,42,"Above 1,000 (b)",11,10
276,EADED,1230,981,249,469,761,E07000200,E10000029,E12000006,42,"Above 1,000 (b)",11,10
277,EADER,10399,7993,2406,4265,6134,E07000143,E10000020,E12000006,33,"Above 10,000 (a)",6,30
278,EADIC,1465,608,857,72,1393,E07000203,E10000029,E12000006,42,"Above 1,000 (b)",11,10
279,EADIS,6447,5706,741,3866,2581,E07000203,E10000029,E12000006,42,"Above 3,000 (b)",9,10
280,EADNE,692,442,250,291,401,E07000242,E10000015,E12000006,26,"Below 1,000 (b)",13,10
281,EADNM,7022,6080,942,4325,2697,E07000146,E10000020,E12000006,33,"Above 3,000 (b)",9,10
282,EADOC,888,532,356,389,499,E07000146,E10000020,E12000006,33,"Below 1,000 (b)",13,10
283,EADOW,8406,8325,81,4878,3528,E07000075,E10000012,E12000006,22,Small City,3,50
284,EADRA,9524,6370,3154,3920,5604,E07000149,E10000020,E12000006,33,"Above 3,000 (b)",9,10
285,EADSM,3371,2626,745,2369,1002,E07000146,E10000020,E12000006,33,"Above 3,000 (b)",9,10
286,EAEBG,1159,1043,116,689,470,E07000200,E10000029,E12000006,42,"Above 1,000 (b)",11,10
287,EAEBY,20997,17369,3628,6756,14241,E07000071,E10000012,E12000006,22,"Above 20,000 (a)",4,30
288,EAEHL,1383,1078,305,892,491,E07000143,E10000020,E12000006,33,"Above 1,000 (b)",11,10
289,EAELC,2668,2059,609,1449,1219,E07000067,E10000012,E12000006,22,"Above 1,000 (b)",11,10
290,EAELM,953,581,372,67,886,E07000143,E10000020,E12000006,33,"Below 1,000 (b)",13,10
291,EAELS,736,315,421,154,582,E07000203,E10000029,E12000006,42,"Below 1,000 (b)",13,10
292,EAELV,209,103,106,34,175,E07000204,E10000029,E12000006,42,"Below 1,000 (b)",13,10
293,EAELY,10106,8967,1139,5438,4668,E07000009,E10000003,E12000006,12,"Above 10,000 (a)",6,30
294,EAEMS,3377,2522,855,1300,2077,E07000203,E10000029,E12000006,42,"Above 3,000 (b)",9,10
295,EAEPP,6188,5396,792,3972,2216,E07000072,E10000012,E12000006,22,"Above 3,000 (a)",8,30
296,EAERD,982,354,628,256,726,E07000146,E10000020,E12000006,33,"Below 1,000 (b)",13,10
297,EAERI,1685,1351,334,1263,422,E07000201,E10000029,E12000006,42,"Above 1,000 (b)",11,10
298,EAESW,553,138,415,83,470,E07000012,E10000003,E12000006,12,"Below 1,000 (b)",13,10
299,EAEWD,12697,12043,654,5882,6815,E07000075,E10000012,E12000006,22,Small City,3,50
300,EAEXN,2577,2444,133,999,1578,E07000009,E10000003,E12000006,12,"Above 1,000 (b)",11,10
301,EAEYE,1329,1126,203,956,373,E07000203,E10000029,E12000006,42,"Above 1,000 (b)",11,10
302,EAEYK,2787,398,2389,169,2618,E07000205,E10000029,E12000006,42,"Above 1,000 (b)",11,10
303,EAFAK,5273,4503,770,3009,2264,E07000143,E10000020,E12000006,33,"Above 3,000 (b)",9,10
304,EAFDM,1573,1176,397,748,825,E07000009,E10000003,E12000006,12,"Above 1,000 (b)",11,10
305,EAFEL,8596,7786,810,5016,3580,E07000205,E10000029,E12000006,42,"Above 3,000 (b)",9,10
306,EAFFD,750,493,257,245,505,E07000203,E10000029,E12000006,42,"Below 1,000 (b)",13,10
307,EAFIN,1429,263,1166,169,1260,E07000146,E10000020,E12000006,33,"Above 1,000 (b)",11,10
308,EAFLE,1045,741,304,369,676,E07000144,E10000020,E12000006,33,"Above 1,000 (b)",11,10
309,EAFLT,1932,1283,649,1067,865,E07000146,E10000020,E12000006,33,"Above 1,000 (a)",10,10
310,EAFME,3461,2732,729,1339,2122,E07000149,E10000020,E12000006,33,"Above 3,000 (a)",8,30
311,EAFML,2029,1665,364,1376,653,E07000205,E10000029,E12000006,42,"Above 1,000 (b)",11,10
312,EAFOR,886,384,502,232,654,E07000071,E10000012,E12000006,22,"Below 1,000 (b)",13,10
313,EAFOU,919,575,344,411,508,E07000143,E10000020,E12000006,33,"Below 1,000 (b)",13,10
314,EAFOW,1647,730,917,513,1134,E07000012,E10000003,E12000006,12,"Above 1,000 (b)",11,10
315,EAFOX,24523,21254,3269,7105,17418,E07000205,E10000029,E12000006,42,"Above 20,000 (b)",5,30
316,EAFRN,10587,7511,3076,3702,6885,E07000076,E10000012,E12000006,22,"Above 10,000 (a)",6,30
317,EAFRP,1587,547,1040,298,1289,E07000149,E10000020,E12000006,33,"Above 1,000 (b)",11,10
318,EAFSD,2267,1561,706,419,1848,E07000077,E10000012,E12000006,22,"Above 1,000 (b)",11,10
319,EAFTN,625,309,316,126,499,E07000206,E10000029,E12000006,42,"Below 1,000 (b)",13,10
320,EAFUL,3630,1839,1791,1542,2088,E07000008,E10000003,E12000006,12,"Above 3,000 (b)",9,10
321,EAFUN,1270,578,692,60,1210,E07000149,E10000020,E12000006,33,"Above 1,000 (b)",11,10
322,EAFXD,4692,4390,302,2658,2034,E07000205,E10000029,E12000006,42,"Above 3,000 (b)",9,10
323,EAFYF,389,373,16,245,144,E07000072,E10000012,E12000006,22,"Below 1,000 (a)",12,10
324,EAGAR,960,417,543,269,691,E07000204,E10000029,E12000006,42,"Below 1,000 (b)",13,10
325,EAGAY,886,672,214,480,406,E07000146,E10000020,E12000006,33,"Below 1,000 (b)",13,10
326,EAGBD,11086,6835,4251,2855,8231,E07000070,E10000012,E12000006,22,"Above 10,000 (b)",7,30
327,EAGBF,1212,654,558,528,684,E07000077,E10000012,E12000006,22,"Above 1,000 (b)",11,10
328,EAGBN,1264,991,273,382,882,E07000204,E10000029,E12000006,42,"Above 1,000 (b)",11,10
329,EAGBT,2173,1179,994,771,1402,E07000076,E10000012,E12000006,22,"Above 1,000 (b)",11,10
330,EAGCR,2512,1513,999,446,2066,E07000143,E10000020,E12000006,33,"Above 1,000 (b)",11,10
331,EAGCT,1425,1081,344,680,745,E07000012,E10000003,E12000006,12,"Above 1,000 (b)",11,10
332,EAGDE,639,234,405,127,512,E07000077,E10000012,E12000006,22,"Below 1,000 (b)",13,10
333,EAGDM,5078,4460,618,3727,1351,E07000077,E10000012,E12000006,22,"Above 3,000 (a)",8,30
334,EAGES,736,472,264,120,616,E07000077,E10000012,E12000006,22,"Below 1,000 (b)",13,10
335,EAGHD,498,354,144,181,317,E07000242,E10000015,E12000006,26,"Below 1,000 (b)",13,10
336,EAGHM,777,302,475,253,524,E07000143,E10000020,E12000006,33,"Below 1,000 (b)",13,10
337,EAGHY,2299,1161,1138,906,1393,E07000071,E10000012,E12000006,22,"Above 1,000 (b)",11,10
338,EAGIR,4873,4456,417,1331,3542,E07000008,E10000003,E12000006,12,"Above 3,000 (b)",9,10
339,EAGLE,3560,1757,1803,1320,2240,E07000067,E10000012,E12000006,22,"Above 3,000 (b)",9,10
340,EAGMS,789,541,248,397,392,E07000146,E10000020,E12000006,33,"Below 1,000 (b)",13,10
341,EAGOL,829,342,487,264,565,E07000074,E10000012,E12000006,22,"Below 1,000 (b)",13,10
342,EAGOR,16831,14611,2220,6201,10630,E07000145,E10000020,E12000006,33,"Above 10,000 (a)",6,30
343,EAGRA,14902,13949,953,7472,7430,E06000034,E99999999,E12000006,00KG,"Above 10,000 (a)",6,30
344,EAGRE,1092,987,105,685,407,E07000143,E10000020,E12000006,33,"Above 1,000 (b)",11,10
345,EAGRU,1138,819,319,670,468,E07000205,E10000029,E12000006,42,"Above 1,000 (b)",11,10
346,EAGRY,655,352,303,193,462,E07000143,E10000020,E12000006,33,"Below 1,000 (b)",13,10
347,EAGSM,496,279,217,198,298,E07000077,E10000012,E12000006,22,"Below 1,000 (b)",13,10
348,EAGST,744,270,474,138,606,E07000146,E10000020,E12000006,33,"Below 1,000 (b)",13,10
349,EAGWH,1749,1327,422,1204,545,E07000200,E10000029,E12000006,42,"Above 1,000 (b)",11,10
350,EAGWK,4373,3840,533,1633,2740,E07000075,E10000012,E12000006,22,"Above 3,000 (b)",9,10
351,EAGYD,1250,875,375,655,595,E07000067,E10000012,E12000006,22,"Above 1,000 (b)",11,10
352,EAGYT,12920,12841,79,6483,6437,E07000145,E10000020,E12000006,33,"Above 10,000 (b)",7,30
353,EAHAE,8088,7962,126,3665,4423,E07000069,E10000012,E12000006,22,Small City,3,50
354,EAHAS,5002,4126,876,2944,2058,E07000200,E10000029,E12000006,42,"Above 3,000 (b)",9,10
355,EAHAT,2071,1819,252,1446,625,E07000067,E10000012,E12000006,22,"Above 1,000 (b)",11,10
356,EAHAV,12489,11281,1208,5783,6706,E07000012,E10000003,E12000006,12,"Above 10,000 (b)",7,30
357,EAHAW,8914,7766,1148,4581,4333,E07000074,E10000012,E12000006,22,"Above 3,000 (b)",9,10
358,EAHBK,1312,694,618,301,1011,E07000200,E10000029,E12000006,42,"Above 1,000 (b)",11,10
359,EAHBO,686,491,195,397,289,E07000077,E10000012,E12000006,22,"Below 1,000 (b)",13,10
360,EAHDM,1999,1631,368,1063,936,E07000012,E10000003,E12000006,12,"Above 1,000 (b)",11,10
361,EAHDN,1027,478,549,402,625,E07000204,E10000029,E12000006,42,"Above 1,000 (b)",11,10
362,EAHEA,4183,2639,1544,1703,2480,E07000146,E10000020,E12000006,33,"Above 3,000 (a)",8,30
363,EAHED,2710,2410,300,1717,993,E07000067,E10000012,E12000006,22,"Above 1,000 (b)",11,10
364,EAHEL,776,126,650,54,722,E07000203,E10000029,E12000006,42,"Below 1,000 (b)",13,10
365,EAHEM,763,574,189,367,396,E07000149,E10000020,E12000006,33,"Below 1,000 (b)",13,10
366,EAHEN,1934,1243,691,376,1558,E07000077,E10000012,E12000006,22,"Above 1,000 (b)",11,10
367,EAHER,2040,826,1214,69,1971,E07000066,E10000012,E12000006,22,"Above 1,000 (b)",11,10
368,EAHET,3415,2992,423,2082,1333,E07000149,E10000020,E12000006,33,"Above 3,000 (b)",9,10
369,EAHEV,1466,678,788,229,1237,E07000144,E10000020,E12000006,33,"Above 1,000 (b)",11,10
370,EAHGM,580,175,405,66,514,E07000200,E10000029,E12000006,42,"Below 1,000 (b)",13,10
371,EAHIC,1222,505,717,271,951,E07000147,E10000020,E12000006,33,"Above 1,000 (a)",10,10
372,EAHIL,925,239,686,94,831,E07000146,E10000020,E12000006,33,"Below 1,000 (b)",13,10
373,EAHIS,4333,3699,634,2716,1617,E07000012,E10000003,E12000006,12,"Above 3,000 (b)",9,10
374,EAHKD,307,134,173,33,274,E07000204,E10000029,E12000006,42,"Below 1,000 (b)",13,10
375,EAHLM,546,377,169,198,348,E07000146,E10000020,E12000006,33,"Below 1,000 (b)",13,10
376,EAHLT,2897,2498,399,2257,640,E07000147,E10000020,E12000006,33,"Above 1,000 (b)",11,10
377,EAHLW,19676,13274,6402,5388,14288,E07000242,E10000015,E12000006,26,"Above 10,000 (a)",6,30
378,EAHNF,1215,262,953,114,1101,E07000070,E10000012,E12000006,22,"Above 1,000 (b)",11,10
379,EAHNG,1921,1201,720,1075,846,E07000149,E10000020,E12000006,33,"Above 1,000 (b)",11,10
380,EAHNS,3254,3207,47,2430,824,E07000146,E10000020,E12000006,33,"Above 3,000 (b)",9,10
381,EAHNT,995,564,431,197,798,E07000204,E10000029,E12000006,42,"Below 1,000 (b)",13,10
382,EAHOH,2477,335,2142,132,2345,E07000143,E10000020,E12000006,33,"Above 1,000 (b)",11,10
383,EAHOL,7472,6407,1065,3273,4199,E07000076,E10000012,E12000006,22,"Above 3,000 (b)",9,10
384,EAHOM,782,478,304,65,717,E07000203,E10000029,E12000006,42,"Below 1,000 (b)",13,10
385,EAHON,1383,313,1070,151,1232,E07000149,E10000020,E12000006,33,"Above 1,000 (b)",11,10
386,EAHOR,1106,757,349,552,554,E07000144,E10000020,E12000006,33,"Above 1,000 (b)",11,10
387,EAHOX,976,366,610,58,918,E07000203,E10000029,E12000006,42,"Below 1,000 (b)",13,10
388,EAHRL,3096,2771,325,2407,689,E07000203,E10000029,E12000006,42,"Above 3,000 (b)",9,10
389,EAHRR,1732,1300,432,363,1369,E07000204,E10000029,E12000006,42,"Above 1,000 (b)",11,10
390,EAHSD,6835,5801,1034,3530,3305,E07000067,E10000012,E12000006,22,"Above 3,000 (b)",9,10
391,EAHST,3050,1338,1712,664,2386,E07000012,E10000003,E12000006,12,"Above 3,000 (b)",9,10
392,EAHSW,3453,3129,324,2078,1375,E07000205,E10000029,E12000006,42,"Above 3,000 (b)",9,10
393,EAHTF,13773,11192,2581,4542,9231,E07000242,E10000015,E12000006,26,"Above 10,000 (b)",7,30
394,EAHTM,517,386,131,161,356,E07000200,E10000029,E12000006,42,"Below 1,000 (b)",13,10
395,EAHTT,784,252,532,174,610,E07000204,E10000029,E12000006,42,"Below 1,000 (b)",13,10
396,EAHUL,3695,3051,644,1839,1856,E07000075,E10000012,E12000006,22,"Above 3,000 (b)",9,10
397,EAHWD,8345,7785,560,3383,4962,E07000071,E10000012,E12000006,22,"Above 3,000 (b)",9,10
398,EAHWH,8571,6964,1607,3308,5263,E07000076,E10000012,E12000006,22,"Above 3,000 (a)",8,30
399,EAHWO,1085,203,882,23,1062,E07000147,E10000020,E12000006,33,"Above 1,000 (b)",11,10
400,EAILK,449,149,300,22,427,E07000206,E10000029,E12000006,42,"Below 1,000 (b)",13,10
401,EAING,3282,2448,834,1839,1443,E07000070,E10000012,E12000006,22,"Above 3,000 (b)",9,10
402,EAIPS,15471,14633,838,6661,8810,E07000200,E10000029,E12000006,42,"Above 10,000 (b)",7,30
403,EAISL,2238,511,1727,29,2209,E07000009,E10000003,E12000006,12,"Above 1,000 (b)",11,10
404,EAKBC,903,522,381,371,532,E07000206,E10000029,E12000006,42,"Below 1,000 (b)",13,10
405,EAKEL,2470,2239,231,1617,853,E07000067,E10000012,E12000006,22,"Above 1,000 (b)",11,10
406,EAKEN,3531,614,2917,358,3173,E07000009,E10000003,E12000006,12,"Above 3,000 (b)",9,10
407,EAKLN,11139,10165,974,5428,5711,E07000146,E10000020,E12000006,33,"Above 10,000 (a)",6,30
408,EAKSG,10432,7347,3085,2256,8176,E07000205,E10000029,E12000006,42,"Above 10,000 (a)",6,30
409,EAKSH,305,237,68,106,199,E07000099,E10000015,E12000006,26,"Below 1,000 (b)",13,10
410,EAKSL,6499,2424,4075,1544,4955,E07000206,E10000029,E12000006,42,"Above 3,000 (a)",8,30
411,EAKTN,2044,1362,682,494,1550,E07000205,E10000029,E12000006,42,"Above 1,000 (b)",11,10
412,EALAI,16787,15528,1259,5664,11123,E07000066,E10000012,E12000006,22,"Above 10,000 (b)",7,30
413,EALAK,2324,2247,77,1749,575,E07000201,E10000029,E12000006,42,"Above 1,000 (b)",11,10
414,EALAT,3121,606,2515,466,2655,E07000074,E10000012,E12000006,22,"Above 3,000 (b)",9,10
415,EALAV,1826,1121,705,788,1038,E07000200,E10000029,E12000006,42,"Above 1,000 (b)",11,10
416,EALAY,1823,755,1068,587,1236,E07000071,E10000012,E12000006,22,"Above 1,000 (a)",10,10
417,EALGH,13051,12915,136,7526,5525,E07000069,E10000012,E12000006,22,Small City,3,50
418,EALIN,427,65,362,27,400,E07000203,E10000029,E12000006,42,"Below 1,000 (b)",13,10
419,EALIT,2638,1398,1240,529,2109,E07000076,E10000012,E12000006,22,"Above 1,000 (b)",11,10
420,EALLN,9383,6168,3215,1831,7552,E07000071,E10000012,E12000006,22,"Above 3,000 (b)",9,10
421,EALNT,2796,2085,711,1610,1186,E07000012,E10000003,E12000006,12,"Above 1,000 (a)",10,10
422,EALOD,2105,1962,143,1184,921,E07000149,E10000020,E12000006,33,"Above 1,000 (b)",11,10
423,EALOW,25848,13735,12113,5989,19859,E07000206,E10000029,E12000006,42,"Above 20,000 (a)",4,30
424,EALPT,3805,3676,129,3018,787,E07000009,E10000003,E12000006,12,"Above 3,000 (a)",8,30
425,EALST,2820,2286,534,1962,858,E07000149,E10000020,E12000006,33,"Above 1,000 (b)",11,10
426,EALTN,3717,3249,468,2606,1111,E07000205,E10000029,E12000006,42,"Above 3,000 (b)",9,10
427,EALWT,1678,1391,287,684,994,E07000070,E10000012,E12000006,22,"Above 1,000 (b)",11,10
428,EAMAL,10872,9658,1214,4251,6621,E07000074,E10000012,E12000006,22,"Above 10,000 (a)",6,30
429,EAMAN,5155,3932,1223,2193,2962,E07000200,E10000029,E12000006,42,"Above 3,000 (b)",9,10
430,EAMBN,3623,2853,770,2012,1611,E07000012,E10000003,E12000006,12,"Above 3,000 (b)",9,10
431,EAMEN,1088,542,546,454,634,E07000203,E10000029,E12000006,42,"Above 1,000 (b)",11,10
432,EAMET,1143,569,574,343,800,E07000146,E10000020,E12000006,33,"Above 1,000 (b)",11,10
433,EAMFD,1023,844,179,641,382,E07000143,E10000020,E12000006,33,"Above 1,000 (b)",11,10
434,EAMHD,1498,792,706,510,988,E07000242,E10000015,E12000006,26,"Above 1,000 (b)",11,10
435,EAMHM,1953,1872,81,1326,627,E07000147,E10000020,E12000006,33,"Above 1,000 (b)",11,10
436,EAMID,2315,1622,693,248,2067,E07000146,E10000020,E12000006,33,"Above 1,000 (b)",11,10
437,EAMIL,7098,4856,2242,3494,3604,E07000201,E10000029,E12000006,42,"Above 3,000 (b)",9,10
438,EAMKT,2352,1209,1143,685,1667,E07000071,E10000012,E12000006,22,"Above 1,000 (b)",11,10
439,EAMLK,791,109,682,46,745,E07000147,E10000020,E12000006,33,"Below 1,000 (b)",13,10
440,EAMLS,1158,439,719,190,968,E07000203,E10000029,E12000006,42,"Above 1,000 (b)",11,10
441,EAMOR,412,280,132,166,246,E07000072,E10000012,E12000006,22,"Below 1,000 (b)",13,10
442,EAMRN,16878,16846,32,10307,6571,E07000075,E10000012,E12000006,22,Small City,3,50
443,EAMTC,2254,1154,1100,535,1719,E07000147,E10000020,E12000006,33,"Above 1,000 (b)",11,10
444,EAMTS,1856,1256,600,573,1283,E07000149,E10000020,E12000006,33,"Above 1,000 (b)",11,10
445,EAMUL,2376,1932,444,1493,883,E07000149,E10000020,E12000006,33,"Above 1,000 (a)",10,10
446,EAMUN,2539,1703,836,1332,1207,E07000147,E10000020,E12000006,33,"Above 1,000 (b)",11,10
447,EANAC,1285,755,530,168,1117,E07000205,E10000029,E12000006,42,"Above 1,000 (b)",11,10
448,EANAR,1278,554,724,444,834,E07000146,E10000020,E12000006,33,"Above 1,000 (b)",11,10
449,EANAY,2214,607,1607,402,1812,E07000200,E10000029,E12000006,42,"Above 1,000 (b)",11,10
450,EANBF,7719,7164,555,3775,3944,E07000066,E10000012,E12000006,22,"Above 3,000 (b)",9,10
451,EANCC,30312,28767,1545,9899,20413,E07000149,E10000020,E12000006,33,"Above 20,000 (b)",5,30
452,EANCN,24529,18368,6161,5519,19010,E07000148,E10000020,E12000006,33,Small City,3,50
453,EANCW,16986,13204,3782,4862,12124,E07000149,E10000020,E12000006,33,"Above 10,000 (b)",7,30
454,EANDL,460,235,225,106,354,E07000146,E10000020,E12000006,33,"Below 1,000 (b)",13,10
455,EANEE,2970,2628,342,2204,766,E07000203,E10000029,E12000006,42,"Above 1,000 (b)",11,10
456,EANEW,1643,617,1026,283,1360,E07000149,E10000020,E12000006,33,"Above 1,000 (b)",11,10
457,EANMK,8173,7989,184,4757,3416,E07000009,E10000003,E12000006,12,"Above 3,000 (b)",9,10
458,EANPT,1853,1105,748,895,958,E07000077,E10000012,E12000006,22,"Above 1,000 (b)",11,10
459,EANWD,2468,2054,414,885,1583,E07000072,E10000012,E12000006,22,"Above 1,000 (b)",11,10
460,EANWS,6784,6174,610,4396,2388,E07000147,E10000020,E12000006,33,"Above 3,000 (b)",9,10
461,EAOCC,819,439,380,208,611,E07000203,E10000029,E12000006,42,"Below 1,000 (b)",13,10
462,EAOFF,1430,513,917,96,1334,E07000200,E10000029,E12000006,42,"Above 1,000 (b)",11,10
463,EAONG,3525,3252,273,2091,1434,E07000072,E10000012,E12000006,22,"Above 3,000 (a)",8,30
464,EAORF,856,512,344,289,567,E07000205,E10000029,E12000006,42,"Below 1,000 (a)",12,10
465,EAORM,2663,1773,890,1165,1498,E07000145,E10000020,E12000006,33,"Above 1,000 (a)",10,10
466,EAORS,3790,1733,2057,701,3089,E06000034,E99999999,E12000006,00KG,"Above 3,000 (b)",9,10
467,EAOUS,472,133,339,6,466,E07000009,E10000003,E12000006,12,"Below 1,000 (b)",13,10
468,EAOVE,1080,954,126,625,455,E07000147,E10000020,E12000006,33,"Above 1,000 (b)",11,10
469,EAPAK,2346,554,1792,230,2116,E07000204,E10000029,E12000006,42,"Above 1,000 (b)",11,10
470,EAPEA,394,360,34,285,109,E07000205,E10000029,E12000006,42,"Below 1,000 (a)",12,10
471,EAPEL,797,281,516,163,634,E07000071,E10000012,E12000006,22,"Below 1,000 (b)",13,10
472,EAPLE,449,200,249,95,354,E07000077,E10000012,E12000006,22,"Below 1,000 (b)",13,10
473,EAPOT,903,847,56,452,451,E07000147,E10000020,E12000006,33,"Below 1,000 (a)",12,10
474,EAPRI,367,185,182,125,242,E07000009,E10000003,E12000006,12,"Below 1,000 (b)",13,10
475,EAPUC,2367,1686,681,1234,1133,E07000242,E10000015,E12000006,26,"Above 1,000 (b)",11,10
476,EAPUL,1176,882,294,426,750,E07000149,E10000020,E12000006,33,"Above 1,000 (b)",11,10
477,EAPUR,964,606,358,265,699,E07000074,E10000012,E12000006,22,"Below 1,000 (b)",13,10
478,EAPYM,1123,850,273,592,531,E07000009,E10000003,E12000006,12,"Above 1,000 (b)",11,10
479,EAQUI,796,203,593,39,757,E07000143,E10000020,E12000006,33,"Below 1,000 (b)",13,10
480,EARAD,850,282,568,127,723,E07000077,E10000012,E12000006,22,"Below 1,000 (b)",13,10
481,EARAT,1292,477,815,319,973,E07000204,E10000029,E12000006,42,"Above 1,000 (b)",11,10
482,EARAV,838,537,301,27,811,E07000149,E10000020,E12000006,33,"Below 1,000 (b)",13,10
483,EARAY,8137,7776,361,3059,5078,E07000075,E10000012,E12000006,22,Small City,3,50
484,EARDH,1644,1228,416,716,928,E07000070,E10000012,E12000006,22,"Above 1,000 (b)",11,10
485,EARDN,2621,1183,1438,689,1932,E07000242,E10000015,E12000006,26,"Above 1,000 (a)",10,10
486,EAREE,2509,1231,1278,999,1510,E07000143,E10000020,E12000006,33,"Above 1,000 (b)",11,10
487,EAREN,499,248,251,147,352,E07000205,E10000029,E12000006,42,"Below 1,000 (b)",13,10
488,EARID,895,375,520,216,679,E07000067,E10000012,E12000006,22,"Below 1,000 (b)",13,10
489,EARMS,2117,537,1580,37,2080,E07000200,E10000029,E12000006,42,"Above 1,000 (b)",11,10
490,EAROC,7645,6192,1453,3193,4452,E07000075,E10000012,E12000006,22,Small City,3,50
491,EAROO,458,163,295,30,428,E07000077,E10000012,E12000006,22,"Below 1,000 (b)",13,10
492,EAROW,4899,2391,2508,1439,3460,E07000071,E10000012,E12000006,22,"Above 3,000 (b)",9,10
493,EAROX,785,263,522,45,740,E07000070,E10000012,E12000006,22,"Below 1,000 (b)",13,10
494,EARST,8567,7649,918,4891,3676,E07000099,E10000015,E12000006,26,"Above 3,000 (a)",8,30
495,EASAB,7083,5519,1564,1849,5234,E07000242,E10000015,E12000006,26,"Above 3,000 (b)",9,10
496,EASAF,8193,7584,609,4665,3528,E07000077,E10000012,E12000006,22,"Above 3,000 (a)",8,30
497,EASAL,3128,1413,1715,781,2347,E07000144,E10000020,E12000006,33,"Above 3,000 (b)",9,10
498,EASAP,457,221,236,51,406,E07000077,E10000012,E12000006,22,"Below 1,000 (b)",13,10
499,EASBF,13078,10745,2333,4553,8525,E07000066,E10000012,E12000006,22,"Above 10,000 (b)",7,30
500,EASBM,1027,696,331,630,397,E07000077,E10000012,E12000006,22,"Above 1,000 (b)",11,10
501,EASBN,970,658,312,537,433,E07000147,E10000020,E12000006,33,"Below 1,000 (b)",13,10
502,EASBW,6256,4984,1272,3709,2547,E07000242,E10000015,E12000006,26,"Above 3,000 (b)",9,10
503,EASBY,6267,6225,42,4364,1903,E07000075,E10000012,E12000006,22,"Above 3,000 (b)",9,10
504,EASCI,16158,14837,1321,7730,8428,E07000008,E10000003,E12000006,12,"Above 10,000 (a)",6,30
505,EASCK,694,484,210,117,577,E07000146,E10000020,E12000006,33,"Below 1,000 (b)",13,10
506,EASCR,373,125,248,43,330,E07000203,E10000029,E12000006,42,"Below 1,000 (b)",13,10
507,EASFM,4515,3883,632,2646,1869,E07000143,E10000020,E12000006,33,"Above 3,000 (b)",9,10
508,EASFR,1357,820,537,506,851,E07000146,E10000020,E12000006,33,"Above 1,000 (b)",11,10
509,EASFT,4551,996,3555,565,3986,E07000148,E10000020,E12000006,33,"Above 3,000 (b)",9,10
510,EASGM,810,589,221,415,395,E07000146,E10000020,E12000006,33,"Below 1,000 (b)",13,10
511,EASGN,1621,456,1165,193,1428,E07000067,E10000012,E12000006,22,"Above 1,000 (b)",11,10
512,EASHE,4694,4633,61,3346,1348,E07000147,E10000020,E12000006,33,"Above 3,000 (b)",9,10
513,EASHI,1354,941,413,536,818,E07000143,E10000020,E12000006,33,"Above 1,000 (b)",11,10
514,EASHL,1125,997,128,641,484,E07000200,E10000029,E12000006,42,"Above 1,000 (b)",11,10
515,EASHM,1169,457,712,333,836,E07000205,E10000029,E12000006,42,"Above 1,000 (b)",11,10
516,EASHR,1762,641,1121,395,1367,E07000077,E10000012,E12000006,22,"Above 1,000 (b)",11,10
517,EASIC,917,465,452,279,638,E07000204,E10000029,E12000006,42,"Below 1,000 (b)",13,10
518,EASIL,2600,1623,977,1423,1177,E07000067,E10000012,E12000006,22,"Above 1,000 (b)",11,10
519,EASIX,358,117,241,75,283,E07000012,E10000003,E12000006,12,"Below 1,000 (b)",13,10
520,EASMA,1140,421,719,235,905,E07000147,E10000020,E12000006,33,"Above 1,000 (b)",11,10
521,EASMD,1292,826,466,365,927,E07000099,E10000015,E12000006,26,"Above 1,000 (b)",11,10
522,EASMN,2312,1935,377,1493,819,E07000074,E10000012,E12000006,22,"Above 1,000 (a)",10,10
523,EASNA,1181,457,724,373,808,E07000205,E10000029,E12000006,42,"Above 1,000 (b)",11,10
524,EASND,20285,17953,2332,10070,10215,E06000033,E99999999,E12000006,00KF,Small City,3,50
525,EASOH,5528,4861,667,2505,3023,E07000009,E10000003,E12000006,12,"Above 3,000 (b)",9,10
526,EASOS,3581,1354,2227,1181,2400,E07000076,E10000012,E12000006,22,"Above 3,000 (b)",9,10
527,EASRM,1501,815,686,754,747,E07000012,E10000003,E12000006,12,"Above 1,000 (b)",11,10
528,EASRP,1082,561,521,313,769,E07000147,E10000020,E12000006,33,"Above 1,000 (a)",10,10
529,EASRY,1112,568,544,493,619,E07000146,E10000020,E12000006,33,"Above 1,000 (b)",11,10
530,EASST,6231,3880,2351,2678,3553,E07000012,E10000003,E12000006,12,"Above 3,000 (b)",9,10
531,EASTB,732,524,208,274,458,E07000077,E10000012,E12000006,22,"Below 1,000 (b)",13,10
532,EASTD,4358,3845,513,2725,1633,E07000242,E10000015,E12000006,26,"Above 3,000 (b)",9,10
533,EASTF,15042,8710,6332,4250,10792,E06000034,E99999999,E12000006,00KG,"Above 10,000 (b)",7,30
534,EASTK,1964,1112,852,814,1150,E07000070,E10000012,E12000006,22,"Above 1,000 (b)",11,10
535,EASTL,2713,2217,496,1642,1071,E07000147,E10000020,E12000006,33,"Above 1,000 (b)",11,10
536,EASTM,12473,9779,2694,4142,8331,E07000203,E10000029,E12000006,42,"Above 10,000 (a)",6,30
537,EASTN,906,381,525,84,822,E07000203,E10000029,E12000006,42,"Below 1,000 (b)",13,10
538,EASTR,1033,653,380,509,524,E07000203,E10000029,E12000006,42,"Above 1,000 (b)",11,10
539,EASTT,2013,1343,670,980,1033,E07000204,E10000029,E12000006,42,"Above 1,000 (b)",11,10
540,EASTW,1110,617,493,211,899,E07000009,E10000003,E12000006,12,"Above 1,000 (b)",11,10
541,EASUD,13735,10375,3360,4858,8877,E07000067,E10000012,E12000006,22,"Above 10,000 (b)",7,30
542,EASUR,1021,517,504,122,899,E07000149,E10000020,E12000006,33,"Above 1,000 (b)",11,10
543,EASUT,2578,2274,304,1343,1235,E07000009,E10000003,E12000006,12,"Above 1,000 (b)",11,10
544,EASWD,3366,3039,327,2027,1339,E07000205,E10000029,E12000006,42,"Above 3,000 (b)",9,10
545,EASWL,764,451,313,230,534,E07000144,E10000020,E12000006,33,"Below 1,000 (b)",13,10
546,EASWM,1181,883,298,439,742,E07000143,E10000020,E12000006,33,"Above 1,000 (b)",11,10
547,EASWN,1473,816,657,646,827,E07000149,E10000020,E12000006,33,"Above 1,000 (b)",11,10
548,EASWO,10285,9154,1131,3907,6378,E07000146,E10000020,E12000006,33,"Above 10,000 (a)",6,30
549,EASWT,1021,344,677,182,839,E07000144,E10000020,E12000006,33,"Above 1,000 (b)",11,10
550,EASWV,2484,1637,847,873,1611,E07000012,E10000003,E12000006,12,"Above 1,000 (a)",10,10
551,EASXM,3024,2674,350,1785,1239,E07000205,E10000029,E12000006,42,"Above 3,000 (b)",9,10
552,EASXP,824,381,443,326,498,E07000144,E10000020,E12000006,33,"Below 1,000 (b)",13,10
553,EASYD,624,89,535,12,612,E07000146,E10000020,E12000006,33,"Below 1,000 (b)",13,10
554,EATER,1342,320,1022,251,1091,E07000067,E10000012,E12000006,22,"Above 1,000 (b)",11,10
555,EATEV,5525,4921,604,3379,2146,E07000008,E10000003,E12000006,12,"Above 3,000 (b)",9,10
556,EATFD,934,210,724,59,875,E07000147,E10000020,E12000006,33,"Below 1,000 (b)",13,10
557,EATHA,1552,1297,255,1186,366,E07000077,E10000012,E12000006,22,"Above 1,000 (b)",11,10
558,EATHB,6629,6583,46,4510,2119,E07000075,E10000012,E12000006,22,Small City,3,50
559,EATHE,11736,10971,765,4273,7463,E07000204,E10000029,E12000006,42,"Above 10,000 (b)",7,30
560,EATHP,11953,8639,3314,1934,10019,E07000149,E10000020,E12000006,33,"Above 10,000 (b)",7,30
561,EATHU,938,464,474,360,578,E07000149,E10000020,E12000006,33,"Below 1,000 (a)",12,10
562,EATIP,4869,4484,385,2849,2020,E07000074,E10000012,E12000006,22,"Above 3,000 (b)",9,10
563,EATIV,1025,497,528,206,819,E07000149,E10000020,E12000006,33,"Above 1,000 (b)",11,10
564,EATKL,2629,2321,308,1454,1175,E07000077,E10000012,E12000006,22,"Above 1,000 (b)",11,10
565,EATLB,7811,5326,2485,3963,3848,E06000034,E99999999,E12000006,00KG,"Above 3,000 (b)",9,10
566,EATLL,988,497,491,425,563,E07000074,E10000012,E12000006,22,"Below 1,000 (a)",12,10
567,EATLW,523,217,306,124,399,E07000012,E10000003,E12000006,12,"Below 1,000 (b)",13,10
568,EATNM,496,471,25,376,120,E07000146,E10000020,E12000006,33,"Below 1,000 (b)",13,10
569,EATOL,1766,416,1350,330,1436,E07000074,E10000012,E12000006,22,"Above 1,000 (b)",11,10
570,EATRU,5861,4196,1665,2201,3660,E07000008,E10000003,E12000006,12,"Above 3,000 (b)",9,10
571,EATSC,2302,1600,702,930,1372,E07000146,E10000020,E12000006,33,"Above 1,000 (b)",11,10
572,EATTS,1089,188,901,154,935,E07000143,E10000020,E12000006,33,"Above 1,000 (b)",11,10
573,EATWI,1097,214,883,34,1063,E07000067,E10000012,E12000006,22,"Above 1,000 (b)",11,10
574,EAUBB,754,198,556,32,722,E07000203,E10000029,E12000006,42,"Below 1,000 (b)",13,10
575,EAVAN,11145,10976,169,5570,5575,E07000066,E10000012,E12000006,22,"Above 10,000 (a)",6,30
576,EAWAN,565,398,167,290,275,E07000206,E10000029,E12000006,42,"Below 1,000 (b)",13,10
577,EAWAR,10792,9772,1020,5959,4833,E07000242,E10000015,E12000006,26,"Above 10,000 (b)",7,30
578,EAWAS,1273,1131,142,1060,213,E07000242,E10000015,E12000006,26,"Above 1,000 (b)",11,10
579,EAWBS,2262,1696,566,1147,1115,E07000074,E10000012,E12000006,22,"Above 1,000 (a)",10,10
580,EAWCT,1910,599,1311,48,1862,E07000147,E10000020,E12000006,33,"Above 1,000 (b)",11,10
581,EAWDB,6839,5833,1006,2847,3992,E07000205,E10000029,E12000006,42,"Above 3,000 (a)",8,30
582,EAWDF,7433,6667,766,2223,5210,E07000074,E10000012,E12000006,22,"Above 3,000 (b)",9,10
583,EAWEL,2072,1834,238,1758,314,E07000147,E10000020,E12000006,33,"Above 1,000 (a)",10,10
584,EAWEN,896,168,728,89,807,E07000143,E10000020,E12000006,33,"Below 1,000 (b)",13,10
585,EAWEY,1169,703,466,39,1130,E07000147,E10000020,E12000006,33,"Above 1,000 (b)",11,10
586,EAWFD,15613,14049,1564,5292,10321,E07000075,E10000012,E12000006,22,Small City,3,50
587,EAWHI,14208,12660,1548,6706,7502,E07000200,E10000029,E12000006,42,"Above 10,000 (a)",6,30
588,EAWIL,278,179,99,95,183,E07000070,E10000012,E12000006,22,"Below 1,000 (b)",13,10
589,EAWIN,1943,1472,471,611,1332,E07000147,E10000020,E12000006,33,"Above 1,000 (b)",11,10
590,EAWIV,4844,3128,1716,2779,2065,E07000071,E10000012,E12000006,22,"Above 3,000 (b)",9,10
591,EAWIX,1075,363,712,227,848,E07000076,E10000012,E12000006,22,"Above 1,000 (a)",10,10
592,EAWKB,864,546,318,147,717,E07000204,E10000029,E12000006,42,"Below 1,000 (b)",13,10
593,EAWLD,886,363,523,195,691,E07000205,E10000029,E12000006,42,"Below 1,000 (b)",13,10
594,EAWLM,3405,1907,1498,1523,1882,E07000012,E10000003,E12000006,12,"Above 3,000 (b)",9,10
595,EAWLW,1312,595,717,473,839,E07000204,E10000029,E12000006,42,"Above 1,000 (b)",11,10
596,EAWLY,1044,813,231,531,513,E07000076,E10000012,E12000006,22,"Above 1,000 (b)",11,10
597,EAWMK,1964,1341,623,1104,860,E07000205,E10000029,E12000006,42,"Above 1,000 (b)",11,10
598,EAWMS,3797,3648,149,3042,755,E07000074,E10000012,E12000006,22,"Above 3,000 (b)",9,10
599,EAWOD,576,310,266,232,344,E07000149,E10000020,E12000006,33,"Below 1,000 (b)",13,10
600,EAWOL,1076,596,480,94,982,E07000200,E10000029,E12000006,42,"Above 1,000 (b)",11,10
601,EAWOR,766,430,336,244,522,E07000203,E10000029,E12000006,42,"Below 1,000 (b)",13,10
602,EAWRD,539,181,358,38,501,E07000077,E10000012,E12000006,22,"Below 1,000 (b)",13,10
603,EAWRE,631,525,106,470,161,E07000206,E10000029,E12000006,42,"Below 1,000 (b)",13,10
604,EAWRI,4316,3525,791,2110,2206,E07000070,E10000012,E12000006,22,"Above 3,000 (b)",9,10
605,EAWRO,2195,1924,271,1111,1084,E07000144,E10000020,E12000006,33,"Above 1,000 (b)",11,10
606,EAWRU,1334,1119,215,452,882,E07000147,E10000020,E12000006,33,"Above 1,000 (b)",11,10
607,EAWSM,896,500,396,398,498,E07000147,E10000020,E12000006,33,"Below 1,000 (b)",13,10
608,EAWSP,680,189,491,120,560,E07000143,E10000020,E12000006,33,"Below 1,000 (b)",13,10
609,EAWST,815,414,401,238,577,E07000205,E10000029,E12000006,42,"Below 1,000 (b)",13,10
610,EAWTB,3244,2377,867,1518,1726,E07000012,E10000003,E12000006,12,"Above 3,000 (b)",9,10
611,EAWTH,12080,11837,243,4334,7746,E07000067,E10000012,E12000006,22,"Above 10,000 (a)",6,30
612,EAWTL,2062,1316,746,1098,964,E07000146,E10000020,E12000006,33,"Above 1,000 (b)",11,10
613,EAWTN,3590,3055,535,2245,1345,E07000143,E10000020,E12000006,33,"Above 3,000 (b)",9,10
614,EAWTS,945,428,517,228,717,E07000203,E10000029,E12000006,42,"Below 1,000 (b)",13,10
615,EAWWR,1331,418,913,149,1182,E07000012,E10000003,E12000006,12,"Above 1,000 (b)",11,10
616,EAWYM,7813,6295,1518,3045,4768,E07000149,E10000020,E12000006,33,"Above 3,000 (b)",9,10
617,EAYOX,605,493,112,346,259,E07000205,E10000029,E12000006,42,"Below 1,000 (b)",13,10
618,EMABBOT,794,699,95,544,250,E07000194,E10000028,E12000005,41,"Below 1,000 (b)",13,10
619,EMABRIP,672,161,511,96,576,E07000011,E10000003,E12000006,12,"Below 1,000 (b)",13,10
620,EMALFRE,7321,4418,2903,3250,4071,E07000032,E10000007,E12000004,17,"Above 3,000 (b)",9,10
621,EMALLES,7647,7542,105,3422,4225,E06000015,E99999999,E12000004,00FK,Small City,3,50
622,EMALREW,1634,1527,107,1251,383,E07000194,E10000028,E12000005,41,"Above 1,000 (a)",10,10
623,EMALSTO,295,158,137,57,238,E07000198,E10000028,E12000005,41,"Below 1,000 (b)",13,10
624,EMALVAS,15329,14351,978,5292,10037,E07000039,E10000007,E12000004,17,"Above 10,000 (b)",7,30
625,EMAMBER,3379,2076,1303,574,2805,E07000032,E10000007,E12000004,17,"Above 3,000 (b)",9,10
626,EMANCAS,951,825,126,612,339,E07000141,E10000019,E12000004,32,"Below 1,000 (a)",12,10
627,EMARKWR,7592,6574,1018,4370,3222,E07000176,E10000024,E12000004,37,"Above 3,000 (b)",9,10
628,EMARNOL,27842,23465,4377,7333,20509,E06000018,E99999999,E12000004,00FY,Large City,2,50
629,EMASBOU,5552,4513,1039,3649,1903,E07000193,E10000028,E12000005,41,"Above 3,000 (b)",9,10
630,EMASFOR,1845,1713,132,1328,517,E07000133,E10000018,E12000004,31,"Above 1,000 (b)",11,10
631,EMASHBB,7378,6484,894,4305,3073,E07000134,E10000018,E12000004,31,"Above 3,000 (b)",9,10
632,EMATTHE,7349,5727,1622,4282,3067,E07000218,E10000031,E12000005,44,"Above 3,000 (b)",9,10
633,EMAYLES,10798,10798,0,5256,5542,E06000016,E99999999,E12000004,00FN,Small City,3,50
634,EMBAINT,1350,669,681,406,944,E07000141,E10000019,E12000004,32,"Above 1,000 (b)",11,10
635,EMBAKEW,2337,2279,58,1989,348,E07000035,E10000007,E12000004,17,"Above 1,000 (b)",11,10
636,EMBARTO,3008,2117,891,1793,1215,E07000039,E10000007,E12000004,17,"Above 3,000 (b)",9,10
637,EMBASFO,18518,18011,507,11482,7036,E06000018,E99999999,E12000004,00FY,Large City,2,50
638,EMBEAUM,14178,11535,2643,3516,10662,E07000129,E10000018,E12000004,31,Small City,3,50
639,EMBEEST,22329,15949,6380,8151,14178,E07000172,E10000024,E12000004,37,Large City,2,50
640,EMBELGR,15859,13595,2264,8145,7714,E07000130,E10000018,E12000004,31,"Above 10,000 (b)",7,30
641,EMBELPE,10645,8397,2248,3676,6969,E07000032,E10000007,E12000004,17,"Above 10,000 (a)",6,30
642,EMBENEF,202,139,63,48,154,E07000152,E10000021,E12000004,34,"Below 1,000 (b)",13,10
643,EMBENWI,616,469,147,450,166,E07000011,E10000003,E12000006,12,"Below 1,000 (b)",13,10
644,EMBGWOR,1607,686,921,422,1185,E07000132,E10000018,E12000004,31,"Above 1,000 (b)",11,10
645,EMBILLE,895,480,415,427,468,E07000131,E10000018,E12000004,31,"Below 1,000 (b)",13,10
646,EMBILLI,1068,882,186,606,462,E07000141,E10000019,E12000004,32,"Above 1,000 (b)",11,10
647,EMBILST,1922,1651,271,1413,509,E07000175,E10000024,E12000004,37,"Above 1,000 (b)",11,10
648,EMBINGH,4743,4509,234,2468,2275,E07000176,E10000024,E12000004,37,"Above 3,000 (b)",9,10
649,EMBIRSS,9511,8535,976,3375,6136,E07000130,E10000018,E12000004,31,"Above 3,000 (a)",8,30
650,EMBLAKE,769,297,472,203,566,E07000151,E10000021,E12000004,34,"Below 1,000 (b)",13,10
651,EMBLDWO,8485,2929,5556,532,7953,E07000170,E10000024,E12000004,37,"Above 3,000 (b)",9,10
652,EMBLEAS,988,441,547,259,729,E07000176,E10000024,E12000004,37,"Below 1,000 (b)",13,10
653,EMBLISW,1690,974,716,756,934,E07000155,E10000021,E12000004,34,"Above 1,000 (b)",11,10
654,EMBLLTO,327,186,141,175,152,E07000131,E10000018,E12000004,31,"Below 1,000 (b)",13,10
655,EMBOSTO,19678,16322,3356,6741,12937,E07000137,E10000019,E12000004,32,"Above 10,000 (b)",7,30
656,EMBOTTE,2468,1563,905,1217,1251,E07000176,E10000024,E12000004,37,"Above 1,000 (b)",11,10
657,EMBOURN,8308,7411,897,4435,3873,E07000141,E10000019,E12000004,32,"Above 3,000 (b)",9,10
658,EMBOZEA,2908,997,1911,825,2083,E06000055,E99999999,E12000006,00KB,"Above 1,000 (b)",11,10
659,EMBRAIL,873,360,513,332,541,E07000039,E10000007,E12000004,17,"Below 1,000 (b)",13,10
660,EMBRAUN,14123,11899,2224,4255,9868,E07000129,E10000018,E12000004,31,Small City,3,50
661,EMBREAD,10785,5289,5496,475,10310,E06000015,E99999999,E12000004,00FK,Small City,3,50
662,EMBRIGS,1228,617,611,589,639,E07000152,E10000021,E12000004,34,"Above 1,000 (b)",11,10
663,EMBRIXW,2715,2313,402,1984,731,E07000151,E10000021,E12000004,34,"Above 1,000 (b)",11,10
664,EMBRLAT,7481,5866,1615,3634,3847,E07000153,E10000021,E12000004,34,"Above 3,000 (b)",9,10
665,EMBROUG,44,25,19,0,44,S12000026,S99999999,S99999999,00QE,"Below 1,000 (b)",13,10
666,EMBUCKD,3317,1236,2081,1119,2198,E07000011,E10000003,E12000006,12,"Above 3,000 (b)",9,10
667,EMBUCKM,1370,172,1198,64,1306,E07000133,E10000018,E12000004,31,"Above 1,000 (b)",11,10
668,EMBULWE,23833,19718,4115,7364,16469,E07000170,E10000024,E12000004,37,"Above 20,000 (b)",5,30
669,EMBULWI,308,141,167,83,225,E07000152,E10000021,E12000004,34,"Below 1,000 (b)",13,10
670,EMBURGH,1631,1237,394,1053,578,E07000137,E10000019,E12000004,32,"Above 1,000 (b)",11,10
671,EMBURTJ,2444,1867,577,1356,1088,E07000176,E10000024,E12000004,37,"Above 1,000 (b)",11,10
672,EMBURTO,33072,16856,16216,4389,28683,E07000039,E10000007,E12000004,17,"Above 20,000 (b)",5,30
673,EMBUTTE,1657,1027,630,642,1015,E07000136,E10000019,E12000004,32,"Above 1,000 (b)",11,10
674,EMBYFIE,3187,919,2268,519,2668,E07000221,E10000031,E12000005,44,"Above 3,000 (b)",9,10
675,EMBYTHO,522,173,349,63,459,E07000011,E10000003,E12000006,12,"Below 1,000 (b)",13,10
676,EMCABYT,746,349,397,220,526,E06000017,E99999999,E12000004,00FP,"Below 1,000 (b)",13,10
677,EMCARSI,426,223,203,27,399,E07000035,E10000007,E12000004,17,"Below 1,000 (b)",13,10
678,EMCASTL,4031,3608,423,2798,1233,E07000134,E10000018,E12000004,31,"Above 3,000 (b)",9,10
679,EMCASTO,1027,705,322,462,565,E07000011,E10000003,E12000006,12,"Above 1,000 (b)",11,10
680,EMCENTL,10036,9987,49,5950,4086,E06000016,E99999999,E12000004,00FN,Small City,3,50
681,EMCHALF,11676,10092,1584,3939,7737,E06000018,E99999999,E12000004,00FY,Large City,2,50
682,EMCHAPE,6870,6345,525,1509,5361,E07000151,E10000021,E12000004,34,"Above 3,000 (a)",8,30
683,EMCHATT,5118,4988,130,4242,876,E07000011,E10000003,E12000006,12,"Above 3,000 (b)",9,10
684,EMCHELL,7889,7123,766,4494,3395,E07000039,E10000007,E12000004,17,"Above 3,000 (b)",9,10
685,EMCHRIS,515,333,182,233,282,E07000146,E10000020,E12000006,33,"Below 1,000 (b)",13,10
686,EMCHSTL,3615,2024,1591,1745,1870,E07000137,E10000019,E12000004,32,"Above 3,000 (b)",9,10
687,EMCLIFT,864,348,516,260,604,E07000194,E10000028,E12000005,41,"Below 1,000 (b)",13,10
688,EMCLIPS,718,302,416,199,519,E07000151,E10000021,E12000004,34,"Below 1,000 (b)",13,10
689,EMCLOPT,285,70,215,70,215,E07000152,E10000021,E12000004,34,"Below 1,000 (b)",13,10
690,EMCNTON,769,214,555,182,587,E07000175,E10000024,E12000004,37,"Below 1,000 (b)",13,10
691,EMCOALV,16275,11551,4724,3415,12860,E07000134,E10000018,E12000004,31,"Above 10,000 (b)",7,30
692,EMCOGEN,1496,996,500,612,884,E07000155,E10000021,E12000004,34,"Above 1,000 (b)",11,10
693,EMCOLLI,2084,1380,704,1198,886,E07000175,E10000024,E12000004,37,"Above 1,000 (b)",11,10
694,EMCOTGR,4188,3193,995,2549,1639,E07000176,E10000024,E12000004,37,"Above 3,000 (b)",9,10
695,EMCOTTE,1566,911,655,491,1075,E06000017,E99999999,E12000004,00FP,"Above 1,000 (b)",11,10
696,EMCRANF,635,197,438,139,496,E07000152,E10000021,E12000004,34,"Below 1,000 (b)",13,10
697,EMCRGLN,899,509,390,416,483,E07000141,E10000019,E12000004,32,"Below 1,000 (a)",12,10
698,EMCROWL,1926,1829,97,1593,333,E07000140,E10000019,E12000004,32,"Above 1,000 (a)",10,10
699,EMCROXT,387,81,306,62,325,E07000012,E10000003,E12000006,12,"Below 1,000 (a)",12,10
700,EMCRRBY,16681,13883,2798,4509,12172,E07000152,E10000021,E12000004,34,"Above 10,000 (b)",7,30
701,EMCRTON,1019,662,357,239,780,E07000151,E10000021,E12000004,34,"Above 1,000 (b)",11,10
702,EMCRWLL,1201,550,651,124,1077,E07000141,E10000019,E12000004,32,"Above 1,000 (b)",11,10
703,EMCTSCK,604,163,441,126,478,E07000152,E10000021,E12000004,34,"Below 1,000 (b)",13,10
704,EMCULVE,437,77,360,29,408,E07000141,E10000019,E12000004,32,"Below 1,000 (b)",13,10
705,EMCWRSL,551,364,187,154,397,E07000032,E10000007,E12000004,17,"Below 1,000 (b)",13,10
706,EMDARLE,2996,2419,577,1510,1486,E07000035,E10000007,E12000004,17,"Above 1,000 (a)",10,10
707,EMDAVEN,12202,9243,2959,4837,7365,E07000221,E10000031,E12000005,44,"Above 10,000 (b)",7,30
708,EMDEEPI,691,483,208,390,301,E07000140,E10000019,E12000004,32,"Below 1,000 (a)",12,10
709,EMDESBO,5125,4914,211,3724,1401,E07000151,E10000021,E12000004,34,"Above 3,000 (b)",9,10
710,EMDETHI,1462,709,753,378,1084,E07000032,E10000007,E12000004,17,"Above 1,000 (b)",11,10
711,EMDFFIE,2995,2722,273,1832,1163,E07000036,E10000007,E12000004,17,"Above 1,000 (b)",11,10
712,EMDINGL,719,90,629,83,636,E07000131,E10000018,E12000004,31,"Below 1,000 (b)",13,10
713,EMDNGTN,1892,1331,561,1161,731,E07000141,E10000019,E12000004,32,"Above 1,000 (b)",11,10
714,EMDODDI,1979,1331,648,943,1036,E07000010,E10000003,E12000006,12,"Above 1,000 (b)",11,10
715,EMDOWSB,653,322,331,70,583,E07000141,E10000019,E12000004,32,"Below 1,000 (b)",13,10
716,EMDRAYC,5630,2941,2689,1683,3947,E07000039,E10000007,E12000004,17,"Above 3,000 (b)",9,10
717,EMDRRBB,25723,22504,3219,9348,16375,E06000015,E99999999,E12000004,00FK,Small City,3,50
718,EMDSSFO,3309,1652,1657,1313,1996,E07000132,E10000018,E12000004,31,"Above 3,000 (b)",9,10
719,EMDUDDI,604,299,305,57,547,E06000017,E99999999,E12000004,00FP,"Below 1,000 (a)",12,10
720,EMDUSTO,11982,9270,2712,3867,8115,E07000151,E10000021,E12000004,34,"Above 10,000 (a)",6,30
721,EMEARLS,3744,2622,1122,1087,2657,E07000156,E10000021,E12000004,34,"Above 3,000 (b)",9,10
722,EMEASTB,1546,1279,267,803,743,E07000176,E10000024,E12000004,37,"Above 1,000 (b)",11,10
723,EMEASTH,835,329,506,280,555,E07000151,E10000021,E12000004,34,"Below 1,000 (a)",12,10
724,EMEASTS,1441,358,1083,57,1384,E07000176,E10000024,E12000004,37,"Above 1,000 (b)",11,10
725,EMEASWI,14495,13099,1396,5502,8993,E06000016,E99999999,E12000004,00FN,Small City,3,50
726,EMEDENH,211,98,113,58,153,E07000141,E10000019,E12000004,32,"Below 1,000 (b)",13,10
727,EMEDWAL,9166,7992,1174,3546,5620,E07000176,E10000024,E12000004,37,"Above 3,000 (b)",9,10
728,EMEDWIN,3961,2481,1480,2182,1779,E07000171,E10000024,E12000004,37,"Above 3,000 (b)",9,10
729,EMEKKBY,588,143,445,110,478,E07000137,E10000019,E12000004,32,"Below 1,000 (b)",13,10
730,EMELLAS,583,263,320,87,496,E07000193,E10000028,E12000005,41,"Below 1,000 (b)",13,10
731,EMELTON,753,339,414,290,463,E07000011,E10000003,E12000006,12,"Below 1,000 (b)",13,10
732,EMEMPIN,834,398,436,365,469,E06000017,E99999999,E12000004,00FP,"Below 1,000 (b)",13,10
733,EMERRSS,9635,8537,1098,4012,5623,E07000132,E10000018,E12000004,31,"Above 3,000 (b)",9,10
734,EMESSTL,484,332,152,166,318,E07000131,E10000018,E12000004,31,"Below 1,000 (b)",13,10
735,EMESTLE,3528,3249,279,2565,963,E07000176,E10000024,E12000004,37,"Above 3,000 (b)",9,10
736,EMETWLL,4844,1340,3504,1052,3792,E07000039,E10000007,E12000004,17,"Above 3,000 (b)",9,10
737,EMEVING,10501,10501,0,8173,2328,E06000016,E99999999,E12000004,00FN,Small City,3,50
738,EMEYEPE,5609,2365,3244,2038,3571,E06000031,E99999999,E12000006,00JA,"Above 3,000 (b)",9,10
739,EMFARNS,1641,1360,281,1200,441,E07000175,E10000024,E12000004,37,"Above 1,000 (b)",11,10
740,EMFAZEL,17865,13331,4534,4217,13648,E07000218,E10000031,E12000005,44,"Above 10,000 (b)",7,30
741,EMFENTO,1164,153,1011,60,1104,E07000175,E10000024,E12000004,37,"Above 1,000 (b)",11,10
742,EMFINED,2310,2221,89,1632,678,E07000156,E10000021,E12000004,34,"Above 1,000 (b)",11,10
743,EMFLECK,2303,2099,204,1907,396,E07000129,E10000018,E12000004,31,"Above 1,000 (b)",11,10
744,EMFOLKI,784,406,378,358,426,E07000141,E10000019,E12000004,32,"Below 1,000 (b)",13,10
745,EMFOSDY,386,287,99,188,198,E07000136,E10000019,E12000004,32,"Below 1,000 (a)",12,10
746,EMFRIDA,2060,1225,835,620,1440,E07000146,E10000020,E12000006,33,"Above 1,000 (b)",11,10
747,EMFRISK,735,492,243,315,420,E07000137,E10000019,E12000004,32,"Below 1,000 (b)",13,10
748,EMFULBE,1562,412,1150,134,1428,E07000141,E10000019,E12000004,32,"Above 1,000 (b)",11,10
749,EMGADDE,521,265,256,143,378,E07000130,E10000018,E12000004,31,"Below 1,000 (b)",13,10
750,EMGDDLI,23344,21961,1383,7644,15700,E06000018,E99999999,E12000004,00FY,Large City,2,50
751,EMGEDNE,400,219,181,152,248,E07000140,E10000019,E12000004,32,"Below 1,000 (b)",13,10
752,EMGILLS,783,379,404,20,763,E07000151,E10000021,E12000004,34,"Below 1,000 (b)",13,10
753,EMGLINT,2522,1913,609,688,1834,E07000141,E10000019,E12000004,32,"Above 1,000 (b)",11,10
754,EMGLNFI,16089,11110,4979,5845,10244,E07000132,E10000018,E12000004,31,"Above 10,000 (a)",6,30
755,EMGOSBE,1164,859,305,397,767,E07000136,E10000019,E12000004,32,"Above 1,000 (b)",11,10
756,EMGPONT,511,232,279,132,379,E07000141,E10000019,E12000004,32,"Below 1,000 (b)",13,10
757,EMGRETC,747,193,554,28,719,E07000039,E10000007,E12000004,17,"Below 1,000 (b)",13,10
758,EMGRETL,912,539,373,363,549,E07000035,E10000007,E12000004,17,"Below 1,000 (b)",13,10
759,EMGRETO,11177,10280,897,4842,6335,E07000150,E10000021,E12000004,34,"Above 10,000 (b)",7,30
760,EMGRHAM,23043,13679,9364,5441,17602,E07000141,E10000019,E12000004,32,"Above 20,000 (a)",4,30
761,EMGRTFO,1361,229,1132,54,1307,E06000017,E99999999,E12000004,00FP,"Above 1,000 (b)",11,10
762,EMGRTGL,2178,1410,768,68,2110,E07000129,E10000018,E12000004,31,"Above 1,000 (b)",11,10
763,EMGSCTE,9292,7384,1908,4686,4606,E07000130,E10000018,E12000004,31,"Above 3,000 (b)",9,10
764,EMGTTHA,1829,760,1069,538,1291,E07000176,E10000024,E12000004,37,"Above 1,000 (b)",11,10
765,EMGUYHI,589,400,189,224,365,E07000010,E10000003,E12000006,12,"Below 1,000 (a)",12,10
766,EMHACKL,967,768,199,484,483,E07000155,E10000021,E12000004,34,"Below 1,000 (b)",13,10
767,EMHARDI,18207,12526,5681,4667,13540,E07000155,E10000021,E12000004,34,"Above 10,000 (b)",7,30
768,EMHARRO,14454,13140,1314,4704,9750,E07000156,E10000021,E12000004,34,"Above 10,000 (b)",7,30
769,EMHECKI,2236,1976,260,1474,762,E07000139,E10000019,E12000004,32,"Above 1,000 (b)",11,10
770,EMHINCK,23288,19699,3589,6653,16635,E07000219,E10000031,E12000005,44,"Above 20,000 (b)",5,30
771,EMHLBCH,5520,4339,1181,2965,2555,E07000140,E10000019,E12000004,32,"Above 3,000 (b)",9,10
772,EMHLLTO,348,286,62,243,105,E07000131,E10000018,E12000004,31,"Below 1,000 (b)",13,10
773,EMHNDON,16231,10044,6187,3668,12563,E07000011,E10000003,E12000006,12,"Above 10,000 (b)",7,30
774,EMHNGTN,931,279,652,78,853,E07000141,E10000019,E12000004,32,"Below 1,000 (b)",13,10
775,EMHOARC,400,174,226,49,351,E07000194,E10000028,E12000005,41,"Below 1,000 (b)",13,10
776,EMHOLSJ,460,323,137,112,348,E07000140,E10000019,E12000004,32,"Below 1,000 (b)",13,10
777,EMHOLSM,402,205,197,170,232,E07000140,E10000019,E12000004,32,"Below 1,000 (b)",13,10
778,EMHORSL,5300,2953,2347,769,4531,E07000036,E10000007,E12000004,17,"Above 3,000 (b)",9,10
779,EMHRLST,724,413,311,134,590,E07000194,E10000028,E12000005,41,"Below 1,000 (b)",13,10
780,EMHRRBY,1678,558,1120,323,1355,E07000176,E10000024,E12000004,37,"Above 1,000 (b)",11,10
781,EMHTHER,4996,3050,1946,968,4028,E07000134,E10000018,E12000004,31,"Above 3,000 (b)",9,10
782,EMHUBBE,495,222,273,105,390,E07000136,E10000019,E12000004,32,"Below 1,000 (b)",13,10
783,EMHUCKN,17190,13692,3498,5833,11357,E07000170,E10000024,E12000004,37,"Above 10,000 (b)",7,30
784,EMHUGAR,562,115,447,69,493,E07000131,E10000018,E12000004,31,"Below 1,000 (b)",13,10
785,EMHULLA,1093,544,549,416,677,E07000032,E10000007,E12000004,17,"Above 1,000 (b)",11,10
786,EMHURLE,3693,1755,1938,1410,2283,E07000218,E10000031,E12000005,44,"Above 3,000 (b)",9,10
787,EMHUSBB,1025,543,482,484,541,E07000131,E10000018,E12000004,31,"Above 1,000 (b)",11,10
788,EMIBSTO,5447,3580,1867,2289,3158,E07000132,E10000018,E12000004,31,"Above 3,000 (b)",9,10
789,EMILKES,21158,14914,6244,5006,16152,E07000036,E10000007,E12000004,17,Large City,2,50
790,EMINGOL,733,358,375,266,467,E07000141,E10000019,E12000004,32,"Below 1,000 (b)",13,10
791,EMIRTHL,5286,4830,456,2578,2708,E07000152,E10000021,E12000004,34,"Above 3,000 (b)",9,10
792,EMKBWOR,3291,2990,301,1414,1877,E07000131,E10000018,E12000004,31,"Above 3,000 (b)",9,10
793,EMKCLIF,992,731,261,173,819,E07000152,E10000021,E12000004,34,"Below 1,000 (b)",13,10
794,EMKGWOR,2335,1934,401,1010,1325,E07000134,E10000018,E12000004,31,"Above 1,000 (a)",10,10
795,EMKIMBE,9857,5951,3906,2969,6888,E07000172,E10000024,E12000004,37,"Above 3,000 (b)",9,10
796,EMKINGS,22751,20648,2103,7350,15401,E07000154,E10000021,E12000004,34,Small City,3,50
797,EMKINOU,836,389,447,266,570,E07000176,E10000024,E12000004,37,"Below 1,000 (b)",13,10
798,EMKIRKB,12757,9041,3716,4765,7992,E07000170,E10000024,E12000004,37,"Above 10,000 (b)",7,30
799,EMKIRKL,601,329,272,184,417,E07000039,E10000007,E12000004,17,"Below 1,000 (b)",13,10
800,EMKIRTO,3270,2354,916,1986,1284,E07000136,E10000019,E12000004,32,"Above 3,000 (b)",9,10
801,EMKISLI,2815,1381,1434,1066,1749,E07000155,E10000021,E12000004,34,"Above 1,000 (a)",10,10
802,EMKMBLT,1542,715,827,544,998,E07000011,E10000003,E12000006,12,"Above 1,000 (b)",11,10
803,EMKNIPT,824,139,685,62,762,E07000133,E10000018,E12000004,31,"Below 1,000 (b)",13,10
804,EMKNRSS,144,71,73,8,136,E07000010,E10000003,E12000006,12,"Below 1,000 (b)",13,10
805,EMKRBYM,7058,5483,1575,1644,5414,E07000132,E10000018,E12000004,31,"Above 3,000 (b)",9,10
806,EMKTTER,25299,19717,5582,8088,17211,E07000153,E10000021,E12000004,34,"Above 20,000 (b)",5,30
807,EMLANGL,20294,10931,9363,3536,16758,E07000036,E10000007,E12000004,17,Large City,2,50
808,EMLANGR,744,176,568,111,633,E07000137,E10000019,E12000004,32,"Below 1,000 (b)",13,10
809,EMLBENN,1784,1008,776,804,980,E07000176,E10000024,E12000004,37,"Above 1,000 (b)",11,10
810,EMLEABR,9594,7368,2226,3753,5841,E07000032,E10000007,E12000004,17,"Above 3,000 (b)",9,10
811,EMLERRE,1371,478,893,228,1143,E07000131,E10000018,E12000004,31,"Above 1,000 (b)",11,10
812,EMLGHBO,20104,14344,5760,7697,12407,E07000176,E10000024,E12000004,37,"Above 20,000 (b)",5,30
813,EMLNGBU,2200,1867,333,1656,544,E07000151,E10000021,E12000004,34,"Above 1,000 (b)",11,10
814,EMLONGB,19140,19036,104,9905,9235,E06000018,E99999999,E12000004,00FY,Large City,2,50
815,EMLONGE,20945,15459,5486,6338,14607,E07000036,E10000007,E12000004,17,Large City,2,50
816,EMLOWDH,1672,1259,413,956,716,E07000175,E10000024,E12000004,37,"Above 1,000 (b)",11,10
817,EMLSTEE,566,273,293,74,492,E07000137,E10000019,E12000004,32,"Below 1,000 (b)",13,10
818,EMLSUTT,3716,2878,838,2172,1544,E07000140,E10000019,E12000004,32,"Above 3,000 (b)",9,10
819,EMLUTTE,5335,4769,566,3101,2234,E07000220,E10000031,E12000005,44,"Above 3,000 (b)",9,10
820,EMMAARC,10600,10058,542,5798,4802,E07000010,E10000003,E12000006,12,"Above 10,000 (b)",7,30
821,EMMAIDW,327,135,192,104,223,E07000151,E10000021,E12000004,34,"Below 1,000 (b)",13,10
822,EMMANEA,1191,987,204,622,569,E07000009,E10000003,E12000006,12,"Above 1,000 (b)",11,10
823,EMMARCH,1027,657,370,218,809,E07000193,E10000028,E12000005,41,"Above 1,000 (b)",11,10
824,EMMARKB,2672,1133,1539,859,1813,E07000132,E10000018,E12000004,31,"Above 1,000 (b)",11,10
825,EMMARSM,1026,458,568,221,805,E07000146,E10000020,E12000006,33,"Above 1,000 (b)",11,10
826,EMMATLO,7018,6096,922,3843,3175,E07000035,E10000007,E12000004,17,"Above 3,000 (b)",9,10
827,EMMEDBO,541,225,316,150,391,E07000131,E10000018,E12000004,31,"Below 1,000 (b)",13,10
828,EMMELBO,3713,2543,1170,2318,1395,E07000134,E10000018,E12000004,31,"Above 3,000 (b)",9,10
829,EMMELTN,13231,12360,871,5060,8171,E07000133,E10000018,E12000004,31,"Above 10,000 (a)",6,30
830,EMMERES,812,309,503,37,775,E07000011,E10000003,E12000006,12,"Below 1,000 (b)",13,10
831,EMMESHM,3792,2816,976,1803,1989,E07000132,E10000018,E12000004,31,"Above 3,000 (b)",9,10
832,EMMICKL,13539,10456,3083,4556,8983,E07000039,E10000007,E12000004,17,"Above 10,000 (b)",7,30
833,EMMKDEE,7745,5811,1934,3542,4203,E07000141,E10000019,E12000004,32,"Above 3,000 (b)",9,10
834,EMMKFIE,3307,2476,831,1960,1347,E07000132,E10000018,E12000004,31,"Above 3,000 (b)",9,10
835,EMMLCHA,1271,440,831,248,1023,E07000140,E10000019,E12000004,32,"Above 1,000 (a)",10,10
836,EMMLTON,2331,1404,927,413,1918,E07000140,E10000019,E12000004,32,"Above 1,000 (b)",11,10
837,EMMNSFI,42061,21557,20504,6134,35927,E07000170,E10000024,E12000004,37,"Above 20,000 (b)",5,30
838,EMMNTON,658,249,409,160,498,E06000017,E99999999,E12000004,00FP,"Below 1,000 (b)",13,10
839,EMMONTF,17080,15998,1082,6832,10248,E06000016,E99999999,E12000004,00FN,Small City,3,50
840,EMMORCO,858,259,599,140,718,E06000017,E99999999,E12000004,00FP,"Below 1,000 (b)",13,10
841,EMMOULT,12372,11082,1290,3458,8914,E07000151,E10000021,E12000004,34,"Above 10,000 (a)",6,30
842,EMMRKTH,12632,11685,947,6394,6238,E07000131,E10000018,E12000004,31,"Above 10,000 (a)",6,30
843,EMMRTON,1472,1313,159,854,618,E07000141,E10000019,E12000004,32,"Above 1,000 (b)",11,10
844,EMNARBO,10439,7762,2677,2770,7669,E07000129,E10000018,E12000004,31,Small City,3,50
845,EMNEBOR,767,643,124,577,190,E07000141,E10000019,E12000004,32,"Below 1,000 (b)",13,10
846,EMNETHB,1364,507,857,264,1100,E07000176,E10000024,E12000004,37,"Above 1,000 (b)",11,10
847,EMNEWAR,22496,13119,9377,6067,16429,E07000175,E10000024,E12000004,37,"Above 20,000 (b)",5,30
848,EMNEWLE,393,188,205,115,278,E07000137,E10000019,E12000004,32,"Below 1,000 (b)",13,10
849,EMNEWOL,6217,4728,1489,2339,3878,E07000171,E10000024,E12000004,37,"Above 3,000 (b)",9,10
850,EMNEWTO,776,522,254,162,614,E07000218,E10000031,E12000005,44,"Below 1,000 (b)",13,10
851,EMNLUFF,1413,357,1056,21,1392,E06000017,E99999999,E12000004,00FP,"Above 1,000 (b)",11,10
852,EMNORTH,12966,11926,1040,7202,5764,E07000154,E10000021,E12000004,34,Small City,3,50
853,EMNWTON,1361,582,779,196,1165,E07000146,E10000020,E12000006,33,"Above 1,000 (b)",11,10
854,EMOAKHA,7112,6050,1062,4517,2595,E06000017,E99999999,E12000004,00FP,"Above 3,000 (a)",8,30
855,EMODDBY,9375,7909,1466,3558,5817,E07000131,E10000018,E12000004,31,"Above 3,000 (b)",9,10
856,EMOLDLE,1612,807,805,455,1157,E07000136,E10000019,E12000004,32,"Above 1,000 (b)",11,10
857,EMORTON,12844,11257,1587,2433,10411,E07000011,E10000003,E12000006,12,"Above 10,000 (b)",7,30
858,EMOSSGA,2725,1233,1492,146,2579,E07000134,E10000018,E12000004,31,"Above 1,000 (b)",11,10
859,EMOUNDL,3236,2706,530,2251,985,E07000152,E10000021,E12000004,34,"Above 3,000 (a)",8,30
860,EMOVERS,5238,2035,3203,1030,4208,E07000134,E10000018,E12000004,31,"Above 3,000 (b)",9,10
861,EMPADVE,1311,749,562,283,1028,E07000010,E10000003,E12000006,12,"Above 1,000 (b)",11,10
862,EMPAPSA,2348,504,1844,20,2328,E07000012,E10000003,E12000006,12,"Above 1,000 (b)",11,10
863,EMPARWI,410,231,179,191,219,E07000035,E10000007,E12000004,17,"Below 1,000 (b)",13,10
864,EMPATTI,1056,791,265,500,556,E07000151,E10000021,E12000004,34,"Above 1,000 (b)",11,10
865,EMPAULE,618,519,99,324,294,E07000155,E10000021,E12000004,34,"Below 1,000 (b)",13,10
866,EMPEATL,1254,320,934,101,1153,E07000131,E10000018,E12000004,31,"Above 1,000 (b)",11,10
867,EMPETER,23725,16299,7426,5625,18100,E07000011,E10000003,E12000006,12,"Above 20,000 (b)",5,30
868,EMPINXT,11007,5156,5851,1921,9086,E07000170,E10000024,E12000004,37,"Above 10,000 (b)",7,30
869,EMPLEAS,4138,2146,1992,1215,2923,E07000170,E10000024,E12000004,37,"Above 3,000 (b)",9,10
870,EMPLUMT,4483,2686,1797,334,4149,E07000176,E10000024,E12000004,37,"Above 3,000 (b)",9,10
871,EMPNCHB,625,437,188,194,431,E07000141,E10000019,E12000004,32,"Below 1,000 (b)",13,10
872,EMPOLSW,7133,3681,3452,1869,5264,E07000218,E10000031,E12000005,44,"Above 3,000 (b)",9,10
873,EMPREST,572,207,365,8,564,E07000151,E10000021,E12000004,34,"Below 1,000 (b)",13,10
874,EMPRTRE,26274,21106,5168,8383,17891,E07000039,E10000007,E12000004,17,"Above 20,000 (b)",5,30
875,EMQURRN,5943,5271,672,2061,3882,E07000130,E10000018,E12000004,31,"Above 3,000 (b)",9,10
876,EMRADCL,4046,3646,400,2996,1050,E07000176,E10000024,E12000004,37,"Above 3,000 (a)",8,30
877,EMRANND,5604,4459,1145,3457,2147,E07000152,E10000021,E12000004,34,"Above 3,000 (b)",9,10
878,EMRDDEE,3452,1280,2172,1113,2339,E07000155,E10000021,E12000004,34,"Above 3,000 (b)",9,10
879,EMRDDIN,10553,4218,6335,3012,7541,E07000176,E10000024,E12000004,37,"Above 10,000 (a)",6,30
880,EMRGATE,557,409,148,224,333,E07000140,E10000019,E12000004,32,"Below 1,000 (b)",13,10
881,EMRMSEY,4500,3665,835,2943,1557,E07000011,E10000003,E12000006,12,"Above 3,000 (a)",8,30
882,EMROCKI,2663,1086,1577,59,2604,E07000131,E10000018,E12000004,31,"Above 1,000 (b)",11,10
883,EMROTHW,4432,3832,600,3328,1104,E07000153,E10000021,E12000004,34,"Above 3,000 (b)",9,10
884,EMROTTB,589,314,275,62,527,E07000130,E10000018,E12000004,31,"Below 1,000 (b)",13,10
885,EMRPLEY,10316,8861,1455,5378,4938,E07000032,E10000007,E12000004,17,"Above 10,000 (a)",6,30
886,EMRPTON,3558,2133,1425,786,2772,E07000039,E10000007,E12000004,17,"Above 3,000 (b)",9,10
887,EMRRSBB,2307,2110,197,486,1821,E07000130,E10000018,E12000004,31,"Above 1,000 (b)",11,10
888,EMRTHLY,5245,4442,803,1713,3532,E07000130,E10000018,E12000004,31,"Above 3,000 (b)",9,10
889,EMRUSHD,18843,16234,2609,7393,11450,E07000152,E10000021,E12000004,34,"Above 10,000 (a)",6,30
890,EMSANDI,15628,10906,4722,4525,11103,E07000036,E10000007,E12000004,17,Large City,2,50
891,EMSAWTR,2930,2460,470,2254,676,E07000011,E10000003,E12000006,12,"Above 1,000 (a)",10,10
892,EMSBSEY,1225,790,435,602,623,E07000137,E10000019,E12000004,32,"Above 1,000 (a)",10,10
893,EMSCALF,471,244,227,187,284,E07000133,E10000018,E12000004,31,"Below 1,000 (b)",13,10
894,EMSCREM,430,110,320,69,361,E07000137,E10000019,E12000004,32,"Below 1,000 (b)",13,10
895,EMSHARD,1565,718,847,538,1027,E07000134,E10000018,E12000004,31,"Above 1,000 (b)",11,10
896,EMSHEPS,7620,6215,1405,4857,2763,E07000134,E10000018,E12000004,31,"Above 3,000 (b)",9,10
897,EMSHIRE,7413,5291,2122,3782,3631,E07000033,E10000007,E12000004,17,"Above 3,000 (b)",9,10
898,EMSHRWO,21054,19468,1586,9412,11642,E06000018,E99999999,E12000004,00FY,Large City,2,50
899,EMSILVE,1501,1171,330,812,689,E07000155,E10000021,E12000004,34,"Above 1,000 (a)",10,10
900,EMSKGNS,10590,9131,1459,5002,5588,E07000137,E10000019,E12000004,32,"Above 10,000 (b)",7,30
901,EMSLEBY,5501,5017,484,2886,2615,E07000130,E10000018,E12000004,31,"Above 3,000 (b)",9,10
902,EMSLFRD,9374,8501,873,4535,4839,E07000139,E10000019,E12000004,32,"Above 3,000 (b)",9,10
903,EMSOMER,736,349,387,235,501,E07000131,E10000018,E12000004,31,"Below 1,000 (b)",13,10
904,EMSOSHM,3728,1735,1993,1506,2222,E07000012,E10000003,E12000006,12,"Above 3,000 (b)",9,10
905,EMSOUTH,3895,3381,514,2810,1085,E07000175,E10000024,E12000004,37,"Above 3,000 (b)",9,10
906,EMSPCOT,4242,3140,1102,1186,3056,E07000129,E10000018,E12000004,31,"Above 3,000 (b)",9,10
907,EMSPDNG,14867,12995,1872,5660,9207,E07000140,E10000019,E12000004,32,"Above 10,000 (a)",6,30
908,EMSPLSB,2680,1960,720,1699,981,E07000137,E10000019,E12000004,32,"Above 1,000 (b)",11,10
909,EMSRAUC,893,230,663,177,716,E07000139,E10000019,E12000004,32,"Below 1,000 (b)",13,10
910,EMSRFLT,1548,558,990,242,1306,E07000140,E10000019,E12000004,32,"Above 1,000 (b)",11,10
911,EMSTBBS,16965,13477,3488,8562,8403,E07000130,E10000018,E12000004,31,"Above 10,000 (b)",7,30
912,EMSTICK,842,526,316,413,429,E07000137,E10000019,E12000004,32,"Below 1,000 (b)",13,10
913,EMSTIVE,13441,8929,4512,3894,9547,E07000012,E10000003,E12000006,12,"Above 10,000 (b)",7,30
914,EMSTKEG,1477,1001,476,811,666,E07000132,E10000018,E12000004,31,"Above 1,000 (b)",11,10
915,EMSTMFD,12094,9987,2107,5293,6801,E06000017,E99999999,E12000004,00FP,"Above 10,000 (a)",6,30
916,EMSTNEO,17903,13563,4340,5138,12765,E07000011,E10000003,E12000006,12,"Above 10,000 (a)",6,30
917,EMSTNYG,8103,8103,0,4936,3167,E06000016,E99999999,E12000004,00FN,Small City,3,50
918,EMSTTEL,4617,3331,1286,1049,3568,E07000129,E10000018,E12000004,31,"Above 3,000 (b)",9,10
919,EMSUBGE,2061,1953,108,1566,495,E07000140,E10000019,E12000004,32,"Above 1,000 (b)",11,10
920,EMSUDBU,649,226,423,73,576,E07000039,E10000007,E12000004,17,"Below 1,000 (b)",13,10
921,EMSUTER,1077,855,222,672,405,E07000136,E10000019,E12000004,32,"Above 1,000 (a)",10,10
922,EMSUTSJ,646,471,175,334,312,E07000010,E10000003,E12000006,12,"Below 1,000 (b)",13,10
923,EMSUTTI,22494,16775,5719,6541,15953,E07000170,E10000024,E12000004,37,"Above 20,000 (a)",4,30
924,EMSUTTO,1156,704,452,428,728,E07000171,E10000024,E12000004,37,"Above 1,000 (b)",11,10
925,EMSWADL,19996,11834,8162,3640,16356,E07000134,E10000018,E12000004,31,"Above 10,000 (b)",7,30
926,EMSWATN,738,453,285,347,391,E07000139,E10000019,E12000004,32,"Below 1,000 (b)",13,10
927,EMSWSHD,1524,1190,334,912,612,E07000139,E10000019,E12000004,32,"Above 1,000 (b)",11,10
928,EMTBSHE,6117,2988,3129,1604,4513,E07000038,E10000007,E12000004,17,"Above 3,000 (b)",9,10
929,EMTERSJ,1294,957,337,589,705,E07000146,E10000020,E12000006,33,"Above 1,000 (b)",11,10
930,EMTGGBY,287,195,92,93,194,E07000131,E10000018,E12000004,31,"Below 1,000 (b)",13,10
931,EMTHIST,1189,437,752,47,1142,E07000133,E10000018,E12000004,31,"Above 1,000 (b)",11,10
932,EMTHORP,439,175,264,104,335,E07000198,E10000028,E12000005,41,"Below 1,000 (b)",13,10
933,EMTHRAP,4388,3130,1258,2402,1986,E07000152,E10000021,E12000004,34,"Above 3,000 (b)",9,10
934,EMTHRNB,14201,12485,1716,4046,10155,E07000131,E10000018,E12000004,31,"Above 10,000 (b)",7,30
935,EMTHRNY,983,891,92,639,344,E06000031,E99999999,E12000006,00JA,"Below 1,000 (b)",13,10
936,EMTHURL,738,428,310,271,467,E07000132,E10000018,E12000004,31,"Below 1,000 (b)",13,10
937,EMTILTO,456,254,202,23,433,E07000131,E10000018,E12000004,31,"Below 1,000 (b)",13,10
938,EMTMWOR,17779,13601,4178,5091,12688,E07000194,E10000028,E12000005,41,"Above 10,000 (b)",7,30
939,EMTNGND,216,108,108,61,155,E07000141,E10000019,E12000004,32,"Below 1,000 (b)",13,10
940,EMTOWCE,5262,4384,878,2976,2286,E07000155,E10000021,E12000004,34,"Above 3,000 (a)",8,30
941,EMTRENT,7966,7928,38,6158,1808,E07000176,E10000024,E12000004,37,"Above 3,000 (b)",9,10
942,EMTRVES,799,245,554,210,589,E07000010,E10000003,E12000006,12,"Below 1,000 (b)",13,10
943,EMTTYDD,635,573,62,187,448,E07000146,E10000020,E12000006,33,"Below 1,000 (b)",13,10
944,EMTUTBU,6109,2977,3132,1630,4479,E07000039,E10000007,E12000004,17,"Above 3,000 (b)",9,10
945,EMTWCRO,866,194,672,116,750,E07000132,E10000018,E12000004,31,"Below 1,000 (b)",13,10
946,EMUPPIN,2480,2094,386,1735,745,E07000131,E10000018,E12000004,31,"Above 1,000 (b)",11,10
947,EMUPWLL,2365,1733,632,1085,1280,E07000146,E10000020,E12000006,33,"Above 1,000 (b)",11,10
948,EMWALGR,2203,626,1577,363,1840,E07000151,E10000021,E12000004,34,"Above 1,000 (b)",11,10
949,EMWALSA,1189,726,463,440,749,E07000146,E10000020,E12000006,33,"Above 1,000 (b)",11,10
950,EMWARBY,2422,1715,707,1488,934,E07000011,E10000003,E12000006,12,"Above 1,000 (a)",10,10
951,EMWARSO,5881,5047,834,2871,3010,E07000171,E10000024,E12000004,37,"Above 3,000 (b)",9,10
952,EMWDHOU,2766,1090,1676,686,2080,E07000134,E10000018,E12000004,31,"Above 1,000 (b)",11,10
953,EMWEDDO,2193,1933,260,1160,1033,E07000151,E10000021,E12000004,34,"Above 1,000 (b)",11,10
954,EMWELFO,728,483,245,405,323,E07000131,E10000018,E12000004,31,"Below 1,000 (b)",13,10
955,EMWELLI,10846,9456,1390,5746,5100,E07000156,E10000021,E12000004,34,"Above 10,000 (b)",7,30
956,EMWELNY,404,245,159,122,282,E07000009,E10000003,E12000006,12,"Below 1,000 (b)",13,10
957,EMWERRI,14784,12456,2328,3618,11166,E06000031,E99999999,E12000006,00JA,"Above 10,000 (b)",7,30
958,EMWESSW,17085,13445,3640,3241,13844,E07000129,E10000018,E12000004,31,Small City,3,50
959,EMWESTO,17085,14363,2722,4793,12292,E07000154,E10000021,E12000004,34,Small City,3,50
960,EMWHAPL,971,453,518,193,778,E07000140,E10000019,E12000004,32,"Below 1,000 (a)",12,10
961,EMWHISS,675,557,118,451,224,E07000133,E10000018,E12000004,31,"Below 1,000 (b)",13,10
962,EMWHITT,6816,6098,718,4108,2708,E07000011,E10000003,E12000006,12,"Above 3,000 (b)",9,10
963,EMWHTTO,1482,863,619,683,799,E07000176,E10000024,E12000004,37,"Above 1,000 (b)",11,10
964,EMWILLO,13703,9080,4623,3230,10473,E07000039,E10000007,E12000004,17,"Above 10,000 (b)",7,30
965,EMWINST,850,684,166,276,574,E07000035,E10000007,E12000004,17,"Below 1,000 (a)",12,10
966,EMWINWI,449,61,388,44,405,E07000011,E10000003,E12000006,12,"Below 1,000 (b)",13,10
967,EMWIOTH,694,185,509,63,631,E06000017,E99999999,E12000004,00FP,"Below 1,000 (b)",13,10
968,EMWIRKS,3924,2980,944,1484,2440,E07000032,E10000007,E12000004,17,"Above 3,000 (b)",9,10
969,EMWISSM,1088,805,283,495,593,E07000010,E10000003,E12000006,12,"Above 1,000 (a)",10,10
970,EMWLTHA,684,448,236,289,395,E07000133,E10000018,E12000004,31,"Below 1,000 (b)",13,10
971,EMWLVEY,1763,488,1275,362,1401,E07000219,E10000031,E12000005,44,"Above 1,000 (b)",11,10
972,EMWMNDH,444,309,135,266,178,E07000133,E10000018,E12000004,31,"Below 1,000 (a)",12,10
973,EMWNFLT,1667,1361,306,1024,643,E07000137,E10000019,E12000004,32,"Above 1,000 (a)",10,10
974,EMWOLEY,1804,37,1767,8,1796,E07000011,E10000003,E12000006,12,"Above 1,000 (b)",11,10
975,EMWOLLA,13101,9182,3919,2609,10492,E07000172,E10000024,E12000004,37,Large City,2,50
976,EMWOODB,4557,3555,1002,2826,1731,E07000175,E10000024,E12000004,37,"Above 3,000 (b)",9,10
977,EMWSBCH,13853,11437,2416,4162,9691,E07000146,E10000020,E12000006,33,"Above 10,000 (b)",7,30
978,EMWSFRD,2101,647,1454,320,1781,E07000011,E10000003,E12000006,12,"Above 1,000 (a)",10,10
979,EMWSTWO,18631,14891,3740,4725,13906,E06000031,E99999999,E12000006,00JA,"Above 10,000 (a)",6,30
980,EMWYSWO,1826,650,1176,446,1380,E07000176,E10000024,E12000004,37,"Above 1,000 (b)",11,10
981,EMYARDL,808,587,221,46,762,E07000155,E10000021,E12000004,34,"Below 1,000 (b)",13,10
982,EMYOULG,947,621,326,533,414,E07000035,E10000007,E12000004,17,"Below 1,000 (b)",13,10
983,EMYXLEY,8734,4983,3751,3216,5518,E07000011,E10000003,E12000006,12,"Above 3,000 (b)",9,10
984,ESABB,15935,15933,2,11106,4829,S12000036,S99999999,S99999999,00QP,Small City,3,50
985,ESABE,727,601,126,522,205,S12000010,S99999999,S99999999,00QM,"Below 1,000 (b)",13,10
986,ESABF,676,425,251,347,329,S12000030,S99999999,S99999999,00RG,"Below 1,000 (b)",13,10
987,ESABL,168,48,120,4,164,S12000041,S99999999,S99999999,00QC,"Below 1,000 (b)",13,10
988,ESABN,794,698,96,646,148,S12000024,S99999999,S99999999,00RB,"Below 1,000 (b)",13,10
989,ESABR,885,858,27,823,62,S12000015,S99999999,S99999999,00QR,"Below 1,000 (b)",13,10
990,ESABY,1306,1167,139,1040,266,S12000024,S99999999,S99999999,00RB,"Above 1,000 (a)",10,10
991,ESACB,751,315,436,22,729,S12000034,S99999999,S99999999,00QB,"Below 1,000 (b)",13,10
992,ESACG,325,78,247,22,303,S12000029,S99999999,S99999999,00RF,"Below 1,000 (b)",13,10
993,ESAIR,1014,883,131,677,337,S12000014,S99999999,S99999999,00QQ,"Above 1,000 (b)",11,10
994,ESALL,12814,8987,3827,4073,8741,S12000014,S99999999,S99999999,00QQ,"Above 10,000 (b)",7,30
995,ESALM,2692,937,1755,642,2050,S12000024,S99999999,S99999999,00RB,"Above 1,000 (b)",11,10
996,ESALV,7282,2771,4511,2251,5031,S12000030,S99999999,S99999999,00RG,"Above 3,000 (b)",9,10
997,ESALY,1600,1404,196,1333,267,S12000041,S99999999,S99999999,00QC,"Above 1,000 (b)",11,10
998,ESAMU,70,15,55,6,64,S12000024,S99999999,S99999999,00RB,"Below 1,000 (b)",13,10
999,ESANC,487,298,189,250,237,S12000026,S99999999,S99999999,00QE,"Below 1,000 (b)",13,10
1000,ESANS,3219,3090,129,1581,1638,S12000015,S99999999,S99999999,00QR,"Above 3,000 (b)",9,10
1001,ESARB,12798,11209,1589,4671,8127,S12000041,S99999999,S99999999,00QC,"Above 10,000 (a)",6,30
1002,ESARH,332,240,92,86,246,S12000041,S99999999,S99999999,00QC,"Below 1,000 (b)",13,10
1003,ESARM,6011,5839,172,3998,2013,S12000040,S99999999,S99999999,00RH,"Above 3,000 (b)",9,10
1004,ESARN,203,126,77,62,141,S12000015,S99999999,S99999999,00QR,"Below 1,000 (b)",13,10
1005,ESARR,2870,2434,436,1903,967,S12000024,S99999999,S99999999,00RB,"Above 1,000 (a)",10,10
1006,ESARY,1298,1215,83,1015,283,S12000015,S99999999,S99999999,00QR,"Above 1,000 (b)",11,10
1007,ESASB,123,57,66,33,90,S12000026,S99999999,S99999999,00QE,"Below 1,000 (b)",13,10
1008,ESASH,176,110,66,76,100,S12000026,S99999999,S99999999,00QE,"Below 1,000 (b)",13,10
1009,ESATH,476,191,285,131,345,S12000010,S99999999,S99999999,00QM,"Below 1,000 (b)",13,10
1010,ESAVO,732,419,313,335,397,S12000040,S99999999,S99999999,00RH,"Below 1,000 (b)",13,10
1011,ESAXE,6500,6500,0,6273,227,S12000042,S99999999,S99999999,00QJ,"Above 3,000 (a)",8,30
1012,ESAYT,687,378,309,332,355,S12000026,S99999999,S99999999,00QE,"Below 1,000 (a)",12,10
1013,ESBAF,772,638,134,594,178,S12000024,S99999999,S99999999,00RB,"Below 1,000 (a)",12,10
1014,ESBAK,2627,1842,785,1271,1356,S12000014,S99999999,S99999999,00QQ,"Above 1,000 (a)",10,10
1015,ESBAL,4992,4401,591,2051,2941,S12000030,S99999999,S99999999,00RG,"Above 3,000 (b)",9,10
1016,ESBAN,9934,6496,3438,3757,6177,S12000030,S99999999,S99999999,00RG,"Above 3,000 (a)",8,30
1017,ESBAT,13115,10489,2626,2904,10211,S12000040,S99999999,S99999999,00RH,"Above 10,000 (b)",7,30
1018,ESBAX,7430,7274,156,5960,1470,S12000042,S99999999,S99999999,00QJ,"Above 3,000 (a)",8,30
1019,ESBBE,320,140,180,95,225,S12000026,S99999999,S99999999,00QE,"Below 1,000 (b)",13,10
1020,ESBIR,305,159,146,110,195,E06000057,E99999999,E12000001,00EM,"Below 1,000 (b)",13,10
1021,ESBLA,476,274,202,193,283,S12000024,S99999999,S99999999,00RB,"Below 1,000 (b)",13,10
1022,ESBLB,431,399,32,232,199,S12000024,S99999999,S99999999,00RB,"Below 1,000 (b)",13,10
1023,ESBLE,145,63,82,2,143,S12000026,S99999999,S99999999,00QE,"Below 1,000 (b)",13,10
1024,ESBLF,558,384,174,379,179,S12000024,S99999999,S99999999,00RB,"Below 1,000 (b)",13,10
1025,ESBLG,370,206,164,183,187,S12000024,S99999999,S99999999,00RB,"Below 1,000 (b)",13,10
1026,ESBLL,107,34,73,5,102,S12000041,S99999999,S99999999,00QC,"Below 1,000 (b)",13,10
1027,ESBLO,1028,712,316,633,395,S12000015,S99999999,S99999999,00QR,"Above 1,000 (b)",11,10
1028,ESBLR,4926,4408,518,2725,2201,S12000024,S99999999,S99999999,00RB,"Above 3,000 (a)",8,30
1029,ESBLY,2741,2672,69,2117,624,S12000024,S99999999,S99999999,00RB,"Above 1,000 (b)",11,10
1030,ESBOA,440,83,357,32,408,S12000015,S99999999,S99999999,00QR,"Below 1,000 (b)",13,10
1031,ESBOB,78,0,78,0,78,S12000024,S99999999,S99999999,00RB,"Below 1,000 (b)",13,10
1032,ESBOC,165,60,105,45,120,S12000024,S99999999,S99999999,00RB,"Below 1,000 (b)",13,10
1033,ESBOD,143,75,68,19,124,S12000041,S99999999,S99999999,00QC,"Below 1,000 (b)",13,10
1034,ESBOE,1784,1378,406,1277,507,S12000024,S99999999,S99999999,00RB,"Above 1,000 (b)",11,10
1035,ESBOG,110,0,110,0,110,S12000024,S99999999,S99999999,00RB,"Below 1,000 (b)",13,10
1036,ESBON,7347,6894,453,3911,3436,S12000040,S99999999,S99999999,00RH,"Above 3,000 (b)",9,10
1037,ESBOR,118,46,72,23,95,S12000026,S99999999,S99999999,00QE,"Below 1,000 (b)",13,10
1038,ESBRA,530,322,208,236,294,S12000024,S99999999,S99999999,00RB,"Below 1,000 (b)",13,10
1039,ESBRE,4374,4129,245,3345,1029,S12000041,S99999999,S99999999,00QC,"Above 3,000 (a)",8,30
1040,ESBRF,9669,9286,383,4197,5472,S12000042,S99999999,S99999999,00QJ,"Above 3,000 (b)",9,10
1041,ESBRO,7609,7284,325,3992,3617,S12000040,S99999999,S99999999,00RH,"Above 3,000 (b)",9,10
1042,ESBUC,5221,4569,652,2238,2983,S12000015,S99999999,S99999999,00QR,"Above 3,000 (b)",9,10
1043,ESBUN,510,441,69,347,163,S12000024,S99999999,S99999999,00RB,"Below 1,000 (a)",12,10
1044,ESBUR,3361,3275,86,3020,341,S12000015,S99999999,S99999999,00QR,"Above 3,000 (b)",9,10
1045,ESBUT,145,44,101,33,112,S12000024,S99999999,S99999999,00RB,"Below 1,000 (b)",13,10
1046,ESBYB,5057,5007,50,2538,2519,S12000014,S99999999,S99999999,00QQ,"Above 3,000 (b)",9,10
1047,ESCAC,73,11,62,0,73,S12000026,S99999999,S99999999,00QE,"Below 1,000 (b)",13,10
1048,ESCAM,301,47,254,21,280,E06000057,E99999999,E12000001,00EM,"Below 1,000 (b)",13,10
1049,ESCAN,138,68,70,34,104,S12000041,S99999999,S99999999,00QC,"Below 1,000 (b)",13,10
1050,ESCAR,3080,2643,437,2281,799,S12000015,S99999999,S99999999,00QR,"Above 3,000 (b)",9,10
1051,ESCAT,589,311,278,53,536,S12000024,S99999999,S99999999,00RB,"Below 1,000 (b)",13,10
1052,ESCAU,5716,5354,362,3417,2299,S12000041,S99999999,S99999999,00QC,"Above 3,000 (b)",9,10
1053,ESCAY,304,134,170,55,249,S12000041,S99999999,S99999999,00QC,"Below 1,000 (b)",13,10
1054,ESCER,934,550,384,420,514,S12000015,S99999999,S99999999,00QR,"Below 1,000 (a)",12,10
1055,ESCHI,1052,809,243,719,333,S12000026,S99999999,S99999999,00QE,"Above 1,000 (a)",10,10
1056,ESCLA,11443,10763,680,5512,5931,S12000041,S99999999,S99999999,00QC,"Above 10,000 (b)",7,30
1057,ESCLD,615,400,215,330,285,S12000026,S99999999,S99999999,00QE,"Below 1,000 (a)",12,10
1058,ESCLF,519,395,124,287,232,S12000026,S99999999,S99999999,00QE,"Below 1,000 (b)",13,10
1059,ESCLH,350,107,243,14,336,S12000024,S99999999,S99999999,00RB,"Below 1,000 (b)",13,10
1060,ESCLO,78,0,78,0,78,S12000041,S99999999,S99999999,00QC,"Below 1,000 (b)",13,10
1061,ESCLR,1771,1655,116,958,813,S12000030,S99999999,S99999999,00RG,"Above 1,000 (a)",10,10
1062,ESCLV,101,26,75,11,90,S12000024,S99999999,S99999999,00RB,"Below 1,000 (b)",13,10
1063,ESCOB,411,306,105,243,168,S12000026,S99999999,S99999999,00QE,"Below 1,000 (a)",12,10
1064,ESCOC,7265,6241,1024,3347,3918,S12000010,S99999999,S99999999,00QM,"Above 3,000 (b)",9,10
1065,ESCOL,422,386,36,197,225,S12000015,S99999999,S99999999,00QR,"Below 1,000 (b)",13,10
1066,ESCOM,1240,1114,126,1009,231,S12000024,S99999999,S99999999,00RB,"Above 1,000 (b)",11,10
1067,ESCOR,11589,11568,21,6173,5416,S12000036,S99999999,S99999999,00QP,Small City,3,50
1068,ESCOU,1462,1206,256,1120,342,S12000024,S99999999,S99999999,00RB,"Above 1,000 (b)",11,10
1069,ESCOW,7406,5668,1738,3620,3786,S12000015,S99999999,S99999999,00QR,"Above 3,000 (b)",9,10
1070,ESCOY,191,77,114,39,152,S12000041,S99999999,S99999999,00QC,"Below 1,000 (b)",13,10
1071,ESCRA,9740,9740,0,4814,4926,S12000036,S99999999,S99999999,00QP,Small City,3,50
1072,ESCRF,4150,3839,311,3011,1139,S12000024,S99999999,S99999999,00RB,"Above 3,000 (a)",8,30
1073,ESCRG,255,78,177,29,226,S12000026,S99999999,S99999999,00QE,"Below 1,000 (b)",13,10
1074,ESCRL,1323,1205,118,1104,219,S12000015,S99999999,S99999999,00QR,"Above 1,000 (b)",11,10
1075,ESCRN,228,81,147,17,211,S12000041,S99999999,S99999999,00QC,"Below 1,000 (b)",13,10
1076,ESCRO,361,121,240,40,321,E06000057,E99999999,E12000001,00EM,"Below 1,000 (b)",13,10
1077,ESCSR,1560,1318,242,1118,442,E06000057,E99999999,E12000001,00EM,"Above 1,000 (b)",11,10
1078,ESCTN,4581,4569,12,2388,2193,S12000036,S99999999,S99999999,00QP,"Above 3,000 (a)",8,30
1079,ESCUP,5444,4878,566,3805,1639,S12000015,S99999999,S99999999,00QR,"Above 3,000 (a)",8,30
1080,ESDAB,4652,4497,155,2619,2033,S12000015,S99999999,S99999999,00QR,"Above 3,000 (b)",9,10
1081,ESDAL,16204,6380,9824,1785,14419,S12000036,S99999999,S99999999,00QP,Small City,3,50
1082,ESDAV,11920,10253,1667,4142,7778,S12000036,S99999999,S99999999,00QP,Small City,3,50
1083,ESDEA,11267,10912,355,5864,5403,S12000036,S99999999,S99999999,00QP,Small City,3,50
1084,ESDEC,3176,2429,747,570,2606,S12000040,S99999999,S99999999,00RH,"Above 3,000 (b)",9,10
1085,ESDEM,631,447,184,358,273,S12000026,S99999999,S99999999,00QE,"Below 1,000 (a)",12,10
1086,ESDEN,5715,5391,324,3391,2324,S12000014,S99999999,S99999999,00QQ,"Above 3,000 (b)",9,10
1087,ESDIR,438,393,45,246,192,S12000010,S99999999,S99999999,00QM,"Below 1,000 (a)",12,10
1088,ESDOL,1597,1428,169,1137,460,S12000024,S99999999,S99999999,00RB,"Above 1,000 (b)",11,10
1089,ESDON,14465,14465,0,10193,4272,S12000036,S99999999,S99999999,00QP,Small City,3,50
1090,ESDOP,276,126,150,79,197,S12000026,S99999999,S99999999,00QE,"Below 1,000 (b)",13,10
1091,ESDOU,1226,1029,197,737,489,S12000030,S99999999,S99999999,00RG,"Above 1,000 (b)",11,10
1092,ESDRO,205,68,137,32,173,S12000026,S99999999,S99999999,00QE,"Below 1,000 (b)",13,10
1093,ESDUF,24340,13937,10403,4832,19508,S12000015,S99999999,S99999999,00QR,"Above 20,000 (a)",4,30
1094,ESDUG,896,530,366,469,427,S12000024,S99999999,S99999999,00RB,"Below 1,000 (b)",13,10
1095,ESDUK,873,788,85,655,218,S12000024,S99999999,S99999999,00RB,"Below 1,000 (b)",13,10
1096,ESDUN,4197,3724,473,2216,1981,S12000030,S99999999,S99999999,00RG,"Above 3,000 (a)",8,30
1097,ESDUR,4665,4360,305,3243,1422,S12000010,S99999999,S99999999,00QM,"Above 3,000 (a)",8,30
1098,ESDUS,2086,1623,463,1423,663,S12000026,S99999999,S99999999,00QE,"Above 1,000 (b)",11,10
1099,ESDYS,7762,6661,1101,4673,3089,S12000015,S99999999,S99999999,00QR,"Above 3,000 (a)",8,30
1100,ESEAL,1095,950,145,887,208,S12000010,S99999999,S99999999,00QM,"Above 1,000 (a)",10,10
1101,ESEAR,1096,957,139,877,219,S12000026,S99999999,S99999999,00QE,"Above 1,000 (b)",11,10
1102,ESEDD,277,169,108,141,136,S12000026,S99999999,S99999999,00QE,"Below 1,000 (b)",13,10
1103,ESEDZ,848,539,309,435,413,S12000034,S99999999,S99999999,00QB,"Below 1,000 (b)",13,10
1104,ESELI,939,939,0,812,127,S12000015,S99999999,S99999999,00QR,"Below 1,000 (a)",12,10
1105,ESERR,925,809,116,716,209,S12000024,S99999999,S99999999,00RB,"Below 1,000 (a)",12,10
1106,ESESS,212,103,109,12,200,S12000024,S99999999,S99999999,00RB,"Below 1,000 (b)",13,10
1107,ESETB,123,85,38,60,63,S12000026,S99999999,S99999999,00QE,"Below 1,000 (b)",13,10
1108,ESETV,79,10,69,10,69,S12000026,S99999999,S99999999,00QE,"Below 1,000 (a)",12,10
1109,ESEYE,2040,2000,40,1945,95,S12000026,S99999999,S99999999,00QE,"Above 1,000 (a)",10,10
1110,ESFAI,13487,11808,1679,7763,5724,S12000041,S99999999,S99999999,00QC,"Above 10,000 (b)",7,30
1111,ESFAL,18317,14470,3847,5358,12959,S12000014,S99999999,S99999999,00QQ,"Above 10,000 (a)",6,30
1112,ESFAR,147,79,68,30,117,S12000041,S99999999,S99999999,00QC,"Below 1,000 (b)",13,10
1113,ESFAU,2665,2359,306,2081,584,S12000040,S99999999,S99999999,00RH,"Above 1,000 (b)",11,10
1114,ESFER,164,66,98,10,154,S12000041,S99999999,S99999999,00QC,"Below 1,000 (b)",13,10
1115,ESFET,432,260,172,214,218,S12000034,S99999999,S99999999,00QB,"Below 1,000 (b)",13,10
1116,ESFFR,8089,7426,663,4428,3661,S12000041,S99999999,S99999999,00QC,"Above 3,000 (a)",8,30
1117,ESFIN,223,127,96,47,176,S12000041,S99999999,S99999999,00QC,"Below 1,000 (b)",13,10
1118,ESFLK,1277,682,595,573,704,S12000015,S99999999,S99999999,00QR,"Above 1,000 (a)",10,10
1119,ESFML,6995,6967,28,4044,2951,S12000036,S99999999,S99999999,00QP,Small City,3,50
1120,ESFOL,149,119,30,86,63,S12000026,S99999999,S99999999,00QE,"Below 1,000 (b)",13,10
1121,ESFOR,621,522,99,399,222,S12000019,S99999999,S99999999,00QW,"Below 1,000 (b)",13,10
1122,ESFOS,621,406,215,287,334,S12000024,S99999999,S99999999,00RB,"Below 1,000 (b)",13,10
1123,ESFOU,15040,15040,0,14282,758,S12000036,S99999999,S99999999,00QP,Small City,3,50
1124,ESFRD,184,74,110,11,173,S12000041,S99999999,S99999999,00QC,"Below 1,000 (b)",13,10
1125,ESFRI,761,559,202,481,280,S12000041,S99999999,S99999999,00QC,"Below 1,000 (b)",13,10
1126,ESGAG,514,349,165,326,188,S12000030,S99999999,S99999999,00RG,"Below 1,000 (b)",13,10
1127,ESGAL,7655,5939,1716,3939,3716,S12000026,S99999999,S99999999,00QE,"Above 3,000 (a)",8,30
1128,ESGAR,231,126,105,87,144,S12000010,S99999999,S99999999,00QM,"Below 1,000 (b)",13,10
1129,ESGAS,232,54,178,4,228,S12000024,S99999999,S99999999,00RB,"Below 1,000 (b)",13,10
1130,ESGAU,593,425,168,326,267,S12000015,S99999999,S99999999,00QR,"Below 1,000 (b)",13,10
1131,ESGIF,594,434,160,379,215,S12000010,S99999999,S99999999,00QM,"Below 1,000 (a)",12,10
1132,ESGLA,442,230,212,167,275,S12000041,S99999999,S99999999,00QC,"Below 1,000 (b)",13,10
1133,ESGLC,11745,7720,4025,2931,8814,S12000015,S99999999,S99999999,00QR,"Above 10,000 (a)",6,30
1134,ESGLE,781,692,89,437,344,S12000024,S99999999,S99999999,00RB,"Below 1,000 (a)",12,10
1135,ESGLF,599,374,225,266,333,S12000024,S99999999,S99999999,00RB,"Below 1,000 (b)",13,10
1136,ESGLI,115,40,75,16,99,S12000041,S99999999,S99999999,00QC,"Below 1,000 (b)",13,10
1137,ESGLL,221,0,221,0,221,S12000024,S99999999,S99999999,00RB,"Below 1,000 (b)",13,10
1138,ESGLM,252,92,160,6,246,S12000024,S99999999,S99999999,00RB,"Below 1,000 (b)",13,10
1139,ESGLN,4774,4098,676,1734,3040,S12000015,S99999999,S99999999,00QR,"Above 3,000 (b)",9,10
1140,ESGLS,5923,4540,1383,3309,2614,S12000015,S99999999,S99999999,00QR,"Above 3,000 (b)",9,10
1141,ESGOW,446,210,236,57,389,S12000041,S99999999,S99999999,00QC,"Below 1,000 (b)",13,10
1142,ESGRA,13227,13026,201,6378,6849,S12000036,S99999999,S99999999,00QP,Small City,3,50
1143,ESGRB,6170,3874,2296,2659,3511,S12000019,S99999999,S99999999,00QW,"Above 3,000 (b)",9,10
1144,ESGRD,352,253,99,206,146,S12000026,S99999999,S99999999,00QE,"Below 1,000 (a)",12,10
1145,ESGRE,500,351,149,295,205,S12000026,S99999999,S99999999,00QE,"Below 1,000 (a)",12,10
1146,ESGRG,9463,8526,937,2417,7046,S12000014,S99999999,S99999999,00QQ,"Above 3,000 (b)",9,10
1147,ESGRT,206,72,134,41,165,S12000026,S99999999,S99999999,00QE,"Below 1,000 (b)",13,10
1148,ESGSH,94,15,79,15,79,S12000034,S99999999,S99999999,00QB,"Below 1,000 (b)",13,10
1149,ESGUL,1468,1378,90,1227,241,S12000010,S99999999,S99999999,00QM,"Above 1,000 (a)",10,10
1150,ESHAD,4797,4559,238,3480,1317,S12000010,S99999999,S99999999,00QM,"Above 3,000 (a)",8,30
1151,ESHAR,2773,1770,1003,1455,1318,S12000040,S99999999,S99999999,00RH,"Above 1,000 (b)",11,10
1152,ESHAW,8211,7875,336,4907,3304,S12000026,S99999999,S99999999,00QE,"Above 3,000 (a)",8,30
1153,ESHER,189,73,116,42,147,S12000026,S99999999,S99999999,00QE,"Below 1,000 (b)",13,10
1154,ESHIL,2062,1898,164,508,1554,S12000034,S99999999,S99999999,00QB,"Above 1,000 (b)",11,10
1155,ESHUM,303,118,185,52,251,S12000019,S99999999,S99999999,00QW,"Below 1,000 (b)",13,10
1156,ESIKG,11293,6921,4372,2929,8364,S12000015,S99999999,S99999999,00QR,"Above 10,000 (a)",6,30
1157,ESIKR,536,189,347,130,406,S12000041,S99999999,S99999999,00QC,"Below 1,000 (b)",13,10
1158,ESINC,1023,700,323,629,394,S12000024,S99999999,S99999999,00RB,"Above 1,000 (b)",11,10
1159,ESINN,2088,1637,451,1545,543,S12000026,S99999999,S99999999,00QE,"Above 1,000 (b)",11,10
1160,ESINW,271,184,87,114,157,S12000010,S99999999,S99999999,00QM,"Below 1,000 (a)",12,10
1161,ESIVA,216,73,143,22,194,S12000041,S99999999,S99999999,00QC,"Below 1,000 (b)",13,10
1162,ESIVB,1943,1514,429,775,1168,S12000033,S99999999,S99999999,00QA,"Above 1,000 (b)",11,10
1163,ESIVG,2209,2092,117,813,1396,S12000024,S99999999,S99999999,00RB,"Above 1,000 (a)",10,10
1164,ESIVS,57,17,40,17,40,S12000030,S99999999,S99999999,00RG,"Below 1,000 (b)",13,10
1165,ESJED,2501,2353,148,1049,1452,S12000026,S99999999,S99999999,00QE,"Above 1,000 (b)",11,10
1166,ESKCA,1631,1495,136,1348,283,S12000015,S99999999,S99999999,00QR,"Above 1,000 (b)",11,10
1167,ESKEL,4276,3990,286,2520,1756,S12000026,S99999999,S99999999,00QE,"Above 3,000 (a)",8,30
1168,ESKEN,388,84,304,27,361,S12000024,S99999999,S99999999,00RB,"Below 1,000 (b)",13,10
1169,ESKGH,1769,1564,205,1375,394,S12000015,S99999999,S99999999,00QR,"Above 1,000 (b)",11,10
1170,ESKGL,1670,891,779,844,826,S12000015,S99999999,S99999999,00QR,"Above 1,000 (b)",11,10
1171,ESKIL,649,499,150,347,302,S12000024,S99999999,S99999999,00RB,"Below 1,000 (b)",13,10
1172,ESKIN,3709,3357,352,1657,2052,S12000024,S99999999,S99999999,00RB,"Above 3,000 (b)",9,10
1173,ESKIP,616,542,74,481,135,S12000030,S99999999,S99999999,00RG,"Below 1,000 (a)",12,10
1174,ESKIR,17969,10934,7035,4979,12990,S12000015,S99999999,S99999999,00QR,"Above 10,000 (a)",6,30
1175,ESKKM,111,27,84,11,100,S12000026,S99999999,S99999999,00QE,"Below 1,000 (b)",13,10
1176,ESKLO,113,66,47,24,89,S12000030,S99999999,S99999999,00RG,"Below 1,000 (b)",13,10
1177,ESKLR,265,126,139,122,143,S12000024,S99999999,S99999999,00RB,"Below 1,000 (b)",13,10
1178,ESKLS,1036,807,229,124,912,S12000041,S99999999,S99999999,00QC,"Above 1,000 (b)",11,10
1179,ESKLY,3581,3394,187,2727,854,S12000024,S99999999,S99999999,00RB,"Above 3,000 (b)",9,10
1180,ESKNR,290,135,155,66,224,S12000024,S99999999,S99999999,00RB,"Below 1,000 (b)",13,10
1181,ESKNW,4691,4271,420,1459,3232,S12000015,S99999999,S99999999,00QR,"Above 3,000 (b)",9,10
1182,ESKRL,3879,1618,2261,477,3402,S12000036,S99999999,S99999999,00QP,"Above 3,000 (b)",9,10
1183,ESKRM,3654,3349,305,2906,748,S12000041,S99999999,S99999999,00QC,"Above 3,000 (b)",9,10
1184,ESLAD,1770,1101,669,751,1019,S12000015,S99999999,S99999999,00QR,"Above 1,000 (b)",11,10
1185,ESLAK,1521,1368,153,1257,264,S12000034,S99999999,S99999999,00QB,"Above 1,000 (a)",10,10
1186,ESLAR,14985,10392,4593,4238,10747,S12000014,S99999999,S99999999,00QQ,"Above 10,000 (b)",7,30
1187,ESLAU,931,831,100,795,136,S12000026,S99999999,S99999999,00QE,"Below 1,000 (b)",13,10
1188,ESLCE,267,171,96,145,122,S12000024,S99999999,S99999999,00RB,"Below 1,000 (b)",13,10
1189,ESLCG,3843,3683,160,3222,621,S12000015,S99999999,S99999999,00QR,"Above 3,000 (b)",9,10
1190,ESLEI,20363,20360,3,17766,2597,S12000036,S99999999,S99999999,00QP,Small City,3,50
1191,ESLEM,126,47,79,34,92,E06000057,E99999999,E12000001,00EM,"Below 1,000 (b)",13,10
1192,ESLEU,1625,1354,271,1004,621,S12000015,S99999999,S99999999,00QR,"Above 1,000 (a)",10,10
1193,ESLEV,7715,7699,16,3816,3899,S12000015,S99999999,S99999999,00QR,"Above 3,000 (b)",9,10
1194,ESLGF,705,578,127,447,258,S12000041,S99999999,S99999999,00QC,"Below 1,000 (b)",13,10
1195,ESLIB,17320,14666,2654,5685,11635,S12000036,S99999999,S99999999,00QP,Small City,3,50
1196,ESLIL,346,164,182,133,213,S12000026,S99999999,S99999999,00QE,"Below 1,000 (b)",13,10
1197,ESLIM,1426,762,664,461,965,S12000015,S99999999,S99999999,00QR,"Above 1,000 (b)",11,10
1198,ESLIN,225,66,159,31,194,S12000041,S99999999,S99999999,00QC,"Below 1,000 (b)",13,10
1199,ESLNW,6574,5447,1127,3321,3253,S12000040,S99999999,S99999999,00RH,"Above 3,000 (b)",9,10
1200,ESLOA,6468,4247,2221,1157,5311,S12000036,S99999999,S99999999,00QP,Small City,3,50
1201,ESLOC,12484,10847,1637,5013,7471,S12000042,S99999999,S99999999,00QJ,"Above 10,000 (a)",6,30
1202,ESLOF,155,48,107,37,118,S12000026,S99999999,S99999999,00QE,"Below 1,000 (b)",13,10
1203,ESLON,1467,1164,303,1088,379,S12000010,S99999999,S99999999,00QM,"Above 1,000 (b)",11,10
1204,ESLTA,1053,872,181,794,259,S12000041,S99999999,S99999999,00QC,"Above 1,000 (a)",10,10
1205,ESLTF,376,140,236,103,273,S12000015,S99999999,S99999999,00QR,"Below 1,000 (b)",13,10
1206,ESLTM,275,130,145,116,159,S12000026,S99999999,S99999999,00QE,"Below 1,000 (b)",13,10
1207,ESLUN,1080,1030,50,953,127,S12000015,S99999999,S99999999,00QR,"Above 1,000 (b)",11,10
1208,ESLUT,203,103,100,29,174,S12000015,S99999999,S99999999,00QR,"Below 1,000 (b)",13,10
1209,ESLVB,9172,8526,646,4268,4904,S12000040,S99999999,S99999999,00RH,"Above 3,000 (b)",9,10
1210,ESLVS,11235,7821,3414,3365,7870,S12000040,S99999999,S99999999,00RH,"Above 10,000 (b)",7,30
1211,ESMAD,354,70,284,14,340,S12000024,S99999999,S99999999,00RB,"Below 1,000 (b)",13,10
1212,ESMAI,2555,2555,0,2481,74,S12000042,S99999999,S99999999,00QJ,"Above 1,000 (a)",10,10
1213,ESMAY,6884,6415,469,3812,3072,S12000036,S99999999,S99999999,00QP,Small City,3,50
1214,ESMEI,463,289,174,216,247,S12000041,S99999999,S99999999,00QC,"Below 1,000 (b)",13,10
1215,ESMEK,225,118,107,80,145,S12000024,S99999999,S99999999,00RB,"Below 1,000 (b)",13,10
1216,ESMEL,2585,1839,746,1052,1533,S12000026,S99999999,S99999999,00QE,"Above 1,000 (b)",11,10
1217,ESMEN,157,54,103,19,138,S12000041,S99999999,S99999999,00QC,"Below 1,000 (b)",13,10
1218,ESMET,722,645,77,570,152,S12000024,S99999999,S99999999,00RB,"Below 1,000 (b)",13,10
1219,ESMID,6250,4704,1546,1883,4367,S12000036,S99999999,S99999999,00QP,"Above 3,000 (b)",9,10
1220,ESMIN,105,47,58,15,90,E06000057,E99999999,E12000001,00EM,"Below 1,000 (b)",13,10
1221,ESMNF,4938,4786,152,2931,2007,S12000041,S99999999,S99999999,00QC,"Above 3,000 (b)",9,10
1222,ESMON,6185,6017,168,3703,2482,S12000041,S99999999,S99999999,00QC,"Above 3,000 (a)",8,30
1223,ESMOR,8680,8680,0,7271,1409,S12000036,S99999999,S99999999,00QP,Small City,3,50
1224,ESMRB,388,222,166,162,226,S12000026,S99999999,S99999999,00QE,"Below 1,000 (b)",13,10
1225,ESMUC,443,225,218,162,281,S12000024,S99999999,S99999999,00RB,"Below 1,000 (b)",13,10
1226,ESMUI,2848,1377,1471,963,1885,S12000041,S99999999,S99999999,00QC,"Above 1,000 (b)",11,10
1227,ESMUS,12127,9790,2337,5419,6708,S12000036,S99999999,S99999999,00QP,Small City,3,50
1228,ESMUT,497,374,123,330,167,S12000024,S99999999,S99999999,00RB,"Below 1,000 (b)",13,10
1229,ESNBF,1365,1161,204,1085,280,S12000024,S99999999,S99999999,00RB,"Above 1,000 (b)",11,10
1230,ESNBG,649,288,361,139,510,S12000041,S99999999,S99999999,00QC,"Below 1,000 (b)",13,10
1231,ESNEW,16801,16388,413,10944,5857,S12000036,S99999999,S99999999,00QP,Small City,3,50
1232,ESNML,2798,1499,1299,883,1915,S12000015,S99999999,S99999999,00QR,"Above 1,000 (b)",11,10
1233,ESNOA,3203,1914,1289,1361,1842,S12000015,S99999999,S99999999,00QR,"Above 3,000 (a)",8,30
1234,ESNPT,2107,1774,333,967,1140,S12000015,S99999999,S99999999,00QR,"Above 1,000 (a)",10,10
1235,ESNRB,3813,3701,112,2898,915,S12000010,S99999999,S99999999,00QM,"Above 3,000 (a)",8,30
1236,ESNRW,579,105,474,16,563,S12000034,S99999999,S99999999,00QB,"Below 1,000 (b)",13,10
1237,ESNTY,603,429,174,372,231,S12000041,S99999999,S99999999,00QC,"Below 1,000 (b)",13,10
1238,ESOXT,289,177,112,103,186,S12000026,S99999999,S99999999,00QE,"Below 1,000 (b)",13,10
1239,ESPAR,8731,8731,0,7888,843,S12000042,S99999999,S99999999,00QJ,"Above 3,000 (a)",8,30
1240,ESPCD,1546,743,803,622,924,S12000010,S99999999,S99999999,00QM,"Above 1,000 (b)",11,10
1241,ESPCK,7641,6801,840,4827,2814,S12000026,S99999999,S99999999,00QE,"Above 3,000 (b)",9,10
1242,ESPEB,4846,4661,185,3356,1490,S12000026,S99999999,S99999999,00QE,"Above 3,000 (a)",8,30
1243,ESPEN,5471,3367,2104,2352,3119,S12000036,S99999999,S99999999,00QP,"Above 3,000 (b)",9,10
1244,ESPER,22996,14729,8267,7157,15839,S12000024,S99999999,S99999999,00RB,"Above 20,000 (a)",4,30
1245,ESPHI,951,370,581,35,916,S12000040,S99999999,S99999999,00RH,"Below 1,000 (b)",13,10
1246,ESPIT,1994,1769,225,1516,478,S12000024,S99999999,S99999999,00RB,"Above 1,000 (b)",11,10
1247,ESPOL,10379,8380,1999,3257,7122,S12000014,S99999999,S99999999,00QQ,"Above 10,000 (b)",7,30
1248,ESPOR,14987,12891,2096,4956,10031,S12000036,S99999999,S99999999,00QP,Small City,3,50
1249,ESPRM,156,34,122,27,129,S12000030,S99999999,S99999999,00RG,"Below 1,000 (b)",13,10
1250,ESPTI,435,107,328,48,387,S12000015,S99999999,S99999999,00QR,"Below 1,000 (b)",13,10
1251,ESQUE,4566,4152,414,2651,1915,S12000015,S99999999,S99999999,00QR,"Above 3,000 (b)",9,10
1252,ESRAI,247,106,141,50,197,S12000024,S99999999,S99999999,00RB,"Below 1,000 (b)",13,10
1253,ESRES,353,258,95,180,173,S12000026,S99999999,S99999999,00QE,"Below 1,000 (a)",12,10
1254,ESROS,10023,10023,0,8769,1254,S12000036,S99999999,S99999999,00QP,Small City,3,50
1255,ESROX,344,190,154,59,285,S12000026,S99999999,S99999999,00QE,"Below 1,000 (b)",13,10
1256,ESSCN,2721,2627,94,1962,759,S12000024,S99999999,S99999999,00RB,"Above 1,000 (b)",11,10
1257,ESSCO,576,383,193,152,424,S12000024,S99999999,S99999999,00RB,"Below 1,000 (b)",13,10
1258,ESSEL,3365,3204,161,2605,760,S12000026,S99999999,S99999999,00QE,"Above 3,000 (b)",9,10
1259,ESSHO,4660,3789,871,2243,2417,S12000044,S99999999,S99999999,00QZ,"Above 3,000 (b)",9,10
1260,ESSLA,848,773,75,610,238,S12000014,S99999999,S99999999,00QQ,"Below 1,000 (b)",13,10
1261,ESSLY,1803,802,1001,746,1057,S12000024,S99999999,S99999999,00RB,"Above 1,000 (b)",11,10
1262,ESSMA,250,73,177,38,212,S12000026,S99999999,S99999999,00QE,"Below 1,000 (b)",13,10
1263,ESSRA,280,124,156,105,175,S12000024,S99999999,S99999999,00RB,"Below 1,000 (b)",13,10
1264,ESSRK,816,442,374,362,454,S12000015,S99999999,S99999999,00QR,"Below 1,000 (b)",13,10
1265,ESSRM,642,469,173,433,209,S12000024,S99999999,S99999999,00RB,"Below 1,000 (b)",13,10
1266,ESSRT,291,153,138,137,154,S12000024,S99999999,S99999999,00RB,"Below 1,000 (b)",13,10
1267,ESSRY,240,134,106,83,157,S12000030,S99999999,S99999999,00RG,"Below 1,000 (b)",13,10
1268,ESSTA,7096,6719,377,4145,2951,S12000015,S99999999,S99999999,00QR,"Above 3,000 (a)",8,30
1269,ESSTB,1998,1466,532,628,1370,S12000026,S99999999,S99999999,00QE,"Above 1,000 (b)",11,10
1270,ESSTC,795,567,228,522,273,S12000034,S99999999,S99999999,00QB,"Below 1,000 (b)",13,10
1271,ESSTF,230,93,137,83,147,S12000024,S99999999,S99999999,00RB,"Below 1,000 (b)",13,10
1272,ESSTH,325,128,197,47,278,S12000026,S99999999,S99999999,00QE,"Below 1,000 (b)",13,10
1273,ESSTI,12422,11194,1228,4656,7766,S12000030,S99999999,S99999999,00RG,"Above 10,000 (a)",6,30
1274,ESSTM,979,909,70,805,174,S12000015,S99999999,S99999999,00QR,"Below 1,000 (a)",12,10
1275,ESSTN,293,205,88,98,195,S12000010,S99999999,S99999999,00QM,"Below 1,000 (b)",13,10
1276,ESSTO,85,29,56,29,56,S12000026,S99999999,S99999999,00QE,"Below 1,000 (b)",13,10
1277,ESSTW,400,358,42,312,88,S12000026,S99999999,S99999999,00QE,"Below 1,000 (b)",13,10
1278,ESSWI,303,181,122,128,175,S12000026,S99999999,S99999999,00QE,"Below 1,000 (b)",13,10
1279,ESSYB,2691,1621,1070,1133,1558,S12000040,S99999999,S99999999,00RH,"Above 1,000 (b)",11,10
1280,ESTAR,109,11,98,11,98,S12000034,S99999999,S99999999,00QB,"Below 1,000 (b)",13,10
1281,ESTAY,2004,1940,64,1772,232,S12000015,S99999999,S99999999,00QR,"Above 1,000 (b)",11,10
1282,ESTEA,409,303,106,123,286,S12000041,S99999999,S99999999,00QC,"Below 1,000 (b)",13,10
1283,ESTEM,240,106,134,61,179,S12000019,S99999999,S99999999,00QW,"Below 1,000 (b)",13,10
1284,ESTEV,128,10,118,10,118,S12000026,S99999999,S99999999,00QE,"Below 1,000 (b)",13,10
1285,ESTHO,358,261,97,236,122,S12000030,S99999999,S99999999,00RG,"Below 1,000 (b)",13,10
1286,ESTIL,3492,3205,287,2404,1088,S12000005,S99999999,S99999999,00QF,"Above 3,000 (b)",9,10
1287,ESTNT,6925,5698,1227,1847,5078,S12000010,S99999999,S99999999,00QM,"Above 3,000 (b)",9,10
1288,ESTRO,99,14,85,0,99,S12000030,S99999999,S99999999,00RG,"Below 1,000 (b)",13,10
1289,ESTRY,114,28,86,4,110,S12000024,S99999999,S99999999,00RB,"Below 1,000 (b)",13,10
1290,ESTUM,127,52,75,19,108,S12000024,S99999999,S99999999,00RB,"Below 1,000 (b)",13,10
1291,ESUPL,487,438,49,397,90,S12000015,S99999999,S99999999,00QR,"Below 1,000 (b)",13,10
1292,ESWAL,522,410,112,334,188,S12000026,S99999999,S99999999,00QE,"Below 1,000 (b)",13,10
1293,ESWAV,14321,14321,0,12519,1802,S12000036,S99999999,S99999999,00QP,Small City,3,50
1294,ESWCA,3461,2618,843,1635,1826,S12000040,S99999999,S99999999,00RH,"Above 3,000 (b)",9,10
1295,ESWES,193,76,117,48,145,S12000026,S99999999,S99999999,00QE,"Below 1,000 (b)",13,10
1296,ESWHA,10637,10573,64,7159,3478,S12000036,S99999999,S99999999,00QP,Small City,3,50
1297,ESWHI,6213,6070,143,4549,1664,S12000040,S99999999,S99999999,00RH,"Above 3,000 (b)",9,10
1298,ESWHK,283,135,148,39,244,S12000010,S99999999,S99999999,00QM,"Below 1,000 (b)",13,10
1299,ESWHS,205,88,117,42,163,S12000026,S99999999,S99999999,00QE,"Below 1,000 (b)",13,10
1300,ESWIN,1959,1692,267,1357,602,S12000036,S99999999,S99999999,00QP,"Above 1,000 (b)",11,10
1301,ESWLI,1121,780,341,708,413,S12000026,S99999999,S99999999,00QE,"Above 1,000 (b)",11,10
1302,ESYAR,78,45,33,15,63,S12000026,S99999999,S99999999,00QE,"Below 1,000 (b)",13,10
1303,ESYET,486,403,83,324,162,E06000057,E99999999,E12000001,00EM,"Below 1,000 (b)",13,10
1304,ESYRF,141,89,52,30,111,S12000026,S99999999,S99999999,00QE,"Below 1,000 (b)",13,10
1305,LCABT,658,296,362,257,401,E07000026,E10000006,E12000002,16,"Below 1,000 (b)",13,10
1306,LCACC,25429,17866,7563,8318,17111,E07000120,E10000017,E12000002,30,"Above 20,000 (a)",4,30
1307,LCADL,4636,4392,244,3158,1478,E07000118,E10000017,E12000002,30,"Above 3,000 (b)",9,10
1308,LCAIM,16735,10252,6483,5699,11036,E08000010,E99999999,E12000002,00BW,"Above 10,000 (b)",7,30
1309,LCAIN,6468,6133,335,3419,3049,E07000127,E10000017,E12000002,30,"Above 3,000 (b)",9,10
1310,LCALL,742,302,440,245,497,E07000026,E10000006,E12000002,16,"Below 1,000 (b)",13,10
1311,LCAMB,2459,2097,362,1627,832,E07000031,E10000006,E12000002,16,"Above 1,000 (a)",10,10
1312,LCAOR,13743,9899,3844,5473,8270,E07000123,E10000017,E12000002,30,Small City,3,50
1313,LCAPB,3877,3249,628,1577,2300,E08000010,E99999999,E12000002,00BW,"Above 3,000 (b)",9,10
1314,LCAPP,2389,1804,585,1098,1291,E07000030,E10000006,E12000002,16,"Above 1,000 (a)",10,10
1315,LCARM,355,29,326,6,349,E07000030,E10000006,E12000002,16,"Below 1,000 (b)",13,10
1316,LCASB,21422,15842,5580,5771,15651,E06000008,E99999999,E12000002,00EX,"Above 20,000 (b)",5,30
1317,LCASD,1752,1458,294,1199,553,E07000121,E10000017,E12000002,30,"Above 1,000 (b)",11,10
1318,LCASL,5005,3955,1050,2069,2936,E08000001,E99999999,E12000002,00BL,"Above 3,000 (b)",9,10
1319,LCASP,2537,1379,1158,773,1764,E07000026,E10000006,E12000002,16,"Above 1,000 (b)",11,10
1320,LCATH,20636,13492,7144,6029,14607,E08000001,E99999999,E12000002,00BL,Large City,2,50
1321,LCBAB,17626,11014,6612,3910,13716,E07000126,E10000017,E12000002,30,Small City,3,50
1322,LCBAC,8970,6428,2542,3781,5189,E07000125,E10000017,E12000002,30,"Above 3,000 (b)",9,10
1323,LCBAD,1065,347,718,71,994,E07000031,E10000006,E12000002,16,"Above 1,000 (a)",10,10
1324,LCBAM,202,129,73,92,110,E07000030,E10000006,E12000002,16,"Below 1,000 (b)",13,10
1325,LCBAN,5695,5509,186,4686,1009,E07000124,E10000017,E12000002,30,"Above 3,000 (b)",9,10
1326,LCBAR,21642,17372,4270,8869,12773,E07000031,E10000006,E12000002,16,"Above 20,000 (b)",5,30
1327,LCBAS,527,137,390,29,498,E07000026,E10000006,E12000002,16,"Below 1,000 (b)",13,10
1328,LCBBN,282,151,131,117,165,E07000121,E10000017,E12000002,30,"Below 1,000 (b)",13,10
1329,LCBEC,863,561,302,304,559,E07000029,E10000006,E12000002,16,"Below 1,000 (b)",13,10
1330,LCBEL,364,312,52,282,82,E06000008,E99999999,E12000002,00EX,"Below 1,000 (b)",13,10
1331,LCBEM,2116,1497,619,962,1154,E07000163,E10000023,E12000003,36,"Above 1,000 (a)",10,10
1332,LCBIR,11035,10406,629,6515,4520,E07000127,E10000017,E12000002,30,"Above 10,000 (b)",7,30
1333,LCBLK,35251,25699,9552,5888,29363,E06000008,E99999999,E12000002,00EX,"Above 20,000 (a)",4,30
1334,LCBLP,8882,8882,0,7508,1374,E06000009,E99999999,E12000002,00EY,Small City,3,50
1335,LCBMO,2770,2311,459,1776,994,E07000028,E10000006,E12000002,16,"Above 1,000 (b)",11,10
1336,LCBOB,443,158,285,107,336,E07000124,E10000017,E12000002,30,"Below 1,000 (b)",13,10
1337,LCBOL,21145,15894,5251,4999,16146,E08000001,E99999999,E12000002,00BL,Large City,2,50
1338,LCBOO,434,270,164,213,221,E07000029,E10000006,E12000002,16,"Below 1,000 (b)",13,10
1339,LCBOR,241,44,197,0,241,E07000026,E10000006,E12000002,16,"Below 1,000 (b)",13,10
1340,LCBRC,1098,470,628,260,838,E07000128,E10000017,E12000002,30,"Above 1,000 (b)",11,10
1341,LCBRH,949,380,569,324,625,E07000030,E10000006,E12000002,16,"Below 1,000 (b)",13,10
1342,LCBRI,2358,1504,854,988,1370,E06000008,E99999999,E12000002,00EX,"Above 1,000 (b)",11,10
1343,LCBRN,5649,3759,1890,610,5039,E07000128,E10000017,E12000002,30,"Above 3,000 (b)",9,10
1344,LCBRS,850,481,369,344,506,E07000031,E10000006,E12000002,16,"Below 1,000 (b)",13,10
1345,LCBRT,746,496,250,261,485,E07000026,E10000006,E12000002,16,"Below 1,000 (b)",13,10
1346,LCBTN,1902,729,1173,602,1300,E07000121,E10000017,E12000002,30,"Above 1,000 (b)",11,10
1347,LCBUG,861,330,531,236,625,E07000028,E10000006,E12000002,16,"Below 1,000 (b)",13,10
1348,LCBUR,30884,22064,8820,5443,25441,E07000125,E10000017,E12000002,30,"Above 20,000 (b)",5,30
1349,LCBUS,4829,4464,365,3117,1712,E07000127,E10000017,E12000002,30,"Above 3,000 (b)",9,10
1350,LCBUT,75,25,50,0,75,E07000026,E10000006,E12000002,16,"Below 1,000 (b)",13,10
1351,LCCAF,4766,3304,1462,2563,2203,E07000121,E10000017,E12000002,30,"Above 3,000 (b)",9,10
1352,LCCAL,407,162,245,112,295,E07000030,E10000006,E12000002,16,"Below 1,000 (b)",13,10
1353,LCCAR,38088,18648,19440,6233,31855,E07000028,E10000006,E12000002,16,"Above 20,000 (a)",4,30
1354,LCCAT,970,387,583,105,865,E07000128,E10000017,E12000002,30,"Below 1,000 (b)",13,10
1355,LCCBK,628,227,401,197,431,E07000030,E10000006,E12000002,16,"Below 1,000 (b)",13,10
1356,LCCHA,1380,747,633,519,861,E07000124,E10000017,E12000002,30,"Above 1,000 (b)",11,10
1357,LCCHE,707,246,461,45,662,E07000031,E10000006,E12000002,16,"Below 1,000 (b)",13,10
1358,LCCHI,706,401,305,318,388,E07000124,E10000017,E12000002,30,"Below 1,000 (b)",13,10
1359,LCCHO,22690,17835,4855,7252,15438,E07000118,E10000017,E12000002,30,Small City,3,50
1360,LCCHU,15388,11357,4031,4536,10852,E07000127,E10000017,E12000002,30,"Above 10,000 (b)",7,30
1361,LCCLA,638,226,412,137,501,E07000163,E10000023,E12000003,36,"Below 1,000 (b)",13,10
1362,LCCLE,5678,3928,1750,2193,3485,E07000029,E10000006,E12000002,16,"Above 3,000 (b)",9,10
1363,LCCLR,8521,7908,613,4916,3605,E07000124,E10000017,E12000002,30,"Above 3,000 (a)",8,30
1364,LCCLV,20961,14874,6087,5532,15429,E07000128,E10000017,E12000002,30,"Above 20,000 (a)",4,30
1365,LCCOC,7099,4873,2226,3895,3204,E07000026,E10000006,E12000002,16,"Above 3,000 (a)",8,30
1366,LCCOL,11897,9079,2818,6290,5607,E07000117,E10000017,E12000002,30,"Above 10,000 (b)",7,30
1367,LCCON,770,607,163,516,254,E07000031,E10000006,E12000002,16,"Below 1,000 (b)",13,10
1368,LCCOP,5056,4249,807,2829,2227,E07000118,E10000017,E12000002,30,"Above 3,000 (b)",9,10
1369,LCCRB,887,212,675,134,753,E07000028,E10000006,E12000002,16,"Below 1,000 (b)",13,10
1370,LCCRG,418,59,359,6,412,E07000030,E10000006,E12000002,16,"Below 1,000 (b)",13,10
1371,LCCRO,751,192,559,82,669,E07000031,E10000006,E12000002,16,"Below 1,000 (b)",13,10
1372,LCCRS,2089,1563,526,1213,876,E07000126,E10000017,E12000002,30,"Above 1,000 (b)",11,10
1373,LCCTN,1486,1302,184,1069,417,E07000121,E10000017,E12000002,30,"Above 1,000 (a)",10,10
1374,LCCUL,736,239,497,208,528,E07000030,E10000006,E12000002,16,"Below 1,000 (b)",13,10
1375,LCDAR,16336,12408,3928,6158,10178,E06000008,E99999999,E12000002,00EX,"Above 10,000 (b)",7,30
1376,LCDAU,19622,17247,2375,9649,9973,E08000001,E99999999,E12000002,00BL,Large City,2,50
1377,LCDEN,497,232,265,161,336,E07000163,E10000023,E12000003,36,"Below 1,000 (b)",13,10
1378,LCDLS,1979,944,1035,731,1248,E07000028,E10000006,E12000002,16,"Above 1,000 (b)",11,10
1379,LCDTF,6333,3932,2401,3707,2626,E07000031,E10000006,E12000002,16,"Above 3,000 (b)",9,10
1380,LCDUN,184,80,104,52,132,E07000124,E10000017,E12000002,30,"Below 1,000 (b)",13,10
1381,LCEAR,3151,2661,490,2141,1010,E07000122,E10000017,E12000002,30,"Above 3,000 (b)",9,10
1382,LCECC,3251,2301,950,1880,1371,E07000126,E10000017,E12000002,30,"Above 3,000 (b)",9,10
1383,LCEGR,4716,3524,1192,2426,2290,E07000029,E10000006,E12000002,16,"Above 3,000 (a)",8,30
1384,LCESK,250,27,223,27,223,E07000031,E10000006,E12000002,16,"Below 1,000 (b)",13,10
1385,LCFAR,27021,17736,9285,5494,21527,E08000001,E99999999,E12000002,00BL,Large City,2,50
1386,LCFLO,1586,1223,363,859,727,E07000031,E10000006,E12000002,16,"Above 1,000 (b)",11,10
1387,LCFLW,12294,11608,686,6584,5710,E07000128,E10000017,E12000002,30,"Above 10,000 (b)",7,30
1388,LCFOM,10651,9909,742,4570,6081,E07000127,E10000017,E12000002,30,"Above 10,000 (a)",6,30
1389,LCFRE,4442,3923,519,2362,2080,E07000119,E10000017,E12000002,30,"Above 3,000 (b)",9,10
1390,LCFTN,1469,650,819,383,1086,E07000121,E10000017,E12000002,30,"Above 1,000 (b)",11,10
1391,LCFUL,11439,10299,1140,6199,5240,E07000123,E10000017,E12000002,30,Small City,3,50
1392,LCGAL,1749,1060,689,926,823,E07000121,E10000017,E12000002,30,"Above 1,000 (b)",11,10
1393,LCGAR,5313,4137,1176,2555,2758,E07000128,E10000017,E12000002,30,"Above 3,000 (b)",9,10
1394,LCGIL,564,286,278,211,353,E07000028,E10000006,E12000002,16,"Below 1,000 (b)",13,10
1395,LCGIS,614,257,357,223,391,E07000124,E10000017,E12000002,30,"Below 1,000 (b)",13,10
1396,LCGLE,516,256,260,193,323,E07000030,E10000006,E12000002,16,"Below 1,000 (b)",13,10
1397,LCGOS,3486,2373,1113,1655,1831,E07000031,E10000006,E12000002,16,"Above 3,000 (a)",8,30
1398,LCGRC,1572,1279,293,515,1057,E07000128,E10000017,E12000002,30,"Above 1,000 (a)",10,10
1399,LCGRE,563,360,203,250,313,E07000031,E10000006,E12000002,16,"Below 1,000 (b)",13,10
1400,LCGRH,12314,9721,2593,4569,7745,E07000120,E10000017,E12000002,30,"Above 10,000 (a)",6,30
1401,LCGRS,558,471,87,396,162,E07000031,E10000006,E12000002,16,"Below 1,000 (a)",12,10
1402,LCGRY,937,388,549,272,665,E07000030,E10000006,E12000002,16,"Below 1,000 (b)",13,10
1403,LCGSF,652,575,77,502,150,E07000029,E10000006,E12000002,16,"Below 1,000 (b)",13,10
1404,LCGYG,322,109,213,67,255,E07000030,E10000006,E12000002,16,"Below 1,000 (b)",13,10
1405,LCHAC,738,319,419,145,593,E07000030,E10000006,E12000002,16,"Below 1,000 (b)",13,10
1406,LCHAL,616,198,418,128,488,E07000028,E10000006,E12000002,16,"Below 1,000 (b)",13,10
1407,LCHAM,3448,1604,1844,1200,2248,E07000128,E10000017,E12000002,30,"Above 3,000 (b)",9,10
1408,LCHAR,4602,3426,1176,1824,2778,E07000026,E10000006,E12000002,16,"Above 3,000 (a)",8,30
1409,LCHAS,1097,530,567,198,899,E07000127,E10000017,E12000002,30,"Above 1,000 (b)",11,10
1410,LCHAW,644,390,254,263,381,E07000031,E10000006,E12000002,16,"Below 1,000 (b)",13,10
1411,LCHAY,810,279,531,156,654,E07000028,E10000006,E12000002,16,"Below 1,000 (b)",13,10
1412,LCHBK,4916,2759,2157,1686,3230,E07000126,E10000017,E12000002,30,"Above 3,000 (b)",9,10
1413,LCHBY,1136,473,663,316,820,E07000121,E10000017,E12000002,30,"Above 1,000 (a)",10,10
1414,LCHET,3630,2491,1139,1597,2033,E07000121,E10000017,E12000002,30,"Above 3,000 (b)",9,10
1415,LCHEW,20408,13910,6498,6836,13572,E08000002,E99999999,E12000002,00BM,Large City,2,50
1416,LCHEY,7644,6826,818,4174,3470,E07000121,E10000017,E12000002,30,"Above 3,000 (b)",9,10
1417,LCHIG,12861,11392,1469,5870,6991,E08000001,E99999999,E12000002,00BL,Large City,2,50
1418,LCHIN,13295,10493,2802,4866,8429,E08000001,E99999999,E12000002,00BL,Large City,2,50
1419,LCHMK,316,246,70,91,225,E07000029,E10000006,E12000002,16,"Below 1,000 (b)",13,10
1420,LCHOG,1814,1492,322,283,1531,E07000126,E10000017,E12000002,30,"Above 1,000 (b)",11,10
1421,LCHOL,1327,1168,159,1050,277,E07000121,E10000017,E12000002,30,"Above 1,000 (b)",11,10
1422,LCHOR,11249,8223,3026,5145,6104,E07000118,E10000017,E12000002,30,Small City,3,50
1423,LCING,1419,1166,253,1009,410,E07000163,E10000023,E12000003,36,"Above 1,000 (b)",11,10
1424,LCKEN,15473,12813,2660,5756,9717,E07000031,E10000006,E12000002,16,"Above 10,000 (b)",7,30
1425,LCKES,3480,3399,81,2683,797,E07000026,E10000006,E12000002,16,"Above 3,000 (a)",8,30
1426,LCKFS,638,474,164,255,383,E07000031,E10000006,E12000002,16,"Below 1,000 (b)",13,10
1427,LCKHA,7235,5482,1753,3332,3903,E07000119,E10000017,E12000002,30,"Above 3,000 (b)",9,10
1428,LCKIR,627,191,436,97,530,E07000028,E10000006,E12000002,16,"Below 1,000 (b)",13,10
1429,LCKKB,829,254,575,212,617,E07000026,E10000006,E12000002,16,"Below 1,000 (b)",13,10
1430,LCKLE,1747,1236,511,952,795,E07000121,E10000017,E12000002,30,"Above 1,000 (a)",10,10
1431,LCKNO,3168,2810,358,1635,1533,E07000128,E10000017,E12000002,30,"Above 3,000 (b)",9,10
1432,LCKST,1671,1214,457,1084,587,E07000166,E10000023,E12000003,36,"Above 1,000 (b)",11,10
1433,LCKTH,892,409,483,245,647,E07000030,E10000006,E12000002,16,"Below 1,000 (b)",13,10
1434,LCLAM,1338,359,979,52,1286,E07000026,E10000006,E12000002,16,"Above 1,000 (b)",11,10
1435,LCLAN,23695,19737,3958,8349,15346,E07000121,E10000017,E12000002,30,"Above 20,000 (a)",4,30
1436,LCLAY,10564,9966,598,6873,3691,E07000128,E10000017,E12000002,30,"Above 10,000 (a)",6,30
1437,LCLAZ,1182,543,639,174,1008,E07000030,E10000006,E12000002,16,"Above 1,000 (b)",11,10
1438,LCLEI,23175,15590,7585,6428,16747,E08000006,E99999999,E12000002,00BR,Large City,2,50
1439,LCLEY,25036,13940,11096,6250,18786,E07000126,E10000017,E12000002,30,Small City,3,50
1440,LCLGD,418,283,135,210,208,E07000031,E10000006,E12000002,16,"Below 1,000 (b)",13,10
1441,LCLIT,11102,7889,3213,3822,7280,E08000033,E99999999,E12000003,00CY,"Above 10,000 (b)",7,30
1442,LCLKB,427,209,218,51,376,E07000031,E10000006,E12000002,16,"Below 1,000 (b)",13,10
1443,LCLNB,710,421,289,251,459,E07000030,E10000006,E12000002,16,"Below 1,000 (b)",13,10
1444,LCLOG,1412,1164,248,1135,277,E07000028,E10000006,E12000002,16,"Above 1,000 (b)",11,10
1445,LCLOI,757,171,586,112,645,E07000026,E10000006,E12000002,16,"Below 1,000 (b)",13,10
1446,LCLON,5003,3914,1089,2927,2076,E07000124,E10000017,E12000002,30,"Above 3,000 (a)",8,30
1447,LCLOR,301,174,127,114,187,E07000026,E10000006,E12000002,16,"Below 1,000 (b)",13,10
1448,LCLOT,5729,3868,1861,2031,3698,E07000126,E10000017,E12000002,30,"Above 3,000 (b)",9,10
1449,LCLYT,9315,6738,2577,2785,6530,E07000119,E10000017,E12000002,30,"Above 3,000 (a)",8,30
1450,LCMAR,7431,4765,2666,3311,4120,E07000026,E10000006,E12000002,16,"Above 3,000 (b)",9,10
1451,LCMAT,17602,15072,2530,8880,8722,E06000009,E99999999,E12000002,00EY,Small City,3,50
1452,LCMEL,2044,1350,694,510,1534,E06000008,E99999999,E12000002,00EX,"Above 1,000 (b)",11,10
1453,LCMIL,1914,1382,532,1025,889,E07000031,E10000006,E12000002,16,"Above 1,000 (b)",11,10
1454,LCMLD,565,283,282,178,387,E07000030,E10000006,E12000002,16,"Below 1,000 (b)",13,10
1455,LCMLM,4225,3632,593,2846,1379,E07000029,E10000006,E12000002,16,"Above 3,000 (a)",8,30
1456,LCMOR,16248,13909,2339,5199,11049,E07000121,E10000017,E12000002,30,"Above 10,000 (a)",6,30
1457,LCNBL,377,127,250,29,348,E07000030,E10000006,E12000002,16,"Below 1,000 (b)",13,10
1458,LCNBR,901,453,448,96,805,E07000031,E10000006,E12000002,16,"Below 1,000 (b)",13,10
1459,LCNEL,24966,18513,6453,8894,16072,E07000117,E10000017,E12000002,30,"Above 20,000 (b)",5,30
1460,LCNIC,263,91,172,18,245,E07000028,E10000006,E12000002,16,"Below 1,000 (b)",13,10
1461,LCNSH,11780,9909,1871,5426,6354,E06000009,E99999999,E12000002,00EY,Small City,3,50
1462,LCORR,20087,17703,2384,6884,13203,E08000010,E99999999,E12000002,00BW,"Above 20,000 (a)",4,30
1463,LCORT,771,237,534,21,750,E07000030,E10000006,E12000002,16,"Below 1,000 (b)",13,10
1464,LCPAD,10563,6745,3818,4188,6375,E07000120,E10000017,E12000002,30,"Above 10,000 (b)",7,30
1465,LCPAR,2163,1900,263,1130,1033,E07000118,E10000017,E12000002,30,"Above 1,000 (b)",11,10
1466,LCPEN,9135,8286,849,6096,3039,E07000030,E10000006,E12000002,16,"Above 3,000 (b)",9,10
1467,LCPEW,11555,9726,1829,3735,7820,E07000126,E10000017,E12000002,30,Small City,3,50
1468,LCPIL,911,678,233,343,568,E07000121,E10000017,E12000002,30,"Below 1,000 (b)",13,10
1469,LCPLB,7296,6376,920,3199,4097,E08000010,E99999999,E12000002,00BW,"Above 3,000 (b)",9,10
1470,LCPLE,6154,4577,1577,2124,4030,E06000008,E99999999,E12000002,00EX,"Above 3,000 (b)",9,10
1471,LCPOU,11586,9020,2566,4763,6823,E07000128,E10000017,E12000002,30,"Above 10,000 (a)",6,30
1472,LCPRE,12444,12127,317,7727,4717,E07000126,E10000017,E12000002,30,Small City,3,50
1473,LCPYB,861,139,722,133,728,E07000030,E10000006,E12000002,16,"Below 1,000 (b)",13,10
1474,LCRAM,6737,5886,851,3169,3568,E06000008,E99999999,E12000002,00EX,"Above 3,000 (b)",9,10
1475,LCRAU,460,124,336,14,446,E07000030,E10000006,E12000002,16,"Below 1,000 (b)",13,10
1476,LCRAV,317,177,140,99,218,E07000029,E10000006,E12000002,16,"Below 1,000 (b)",13,10
1477,LCRDH,337,64,273,42,295,E07000028,E10000006,E12000002,16,"Below 1,000 (b)",13,10
1478,LCRIB,16934,16038,896,6234,10700,E07000126,E10000017,E12000002,30,Small City,3,50
1479,LCRIC,1007,667,340,474,533,E07000124,E10000017,E12000002,30,"Above 1,000 (b)",11,10
1480,LCRKF,1873,745,1128,168,1705,E07000028,E10000006,E12000002,16,"Above 1,000 (b)",11,10
1481,LCROC,39088,22741,16347,5865,33223,E08000005,E99999999,E12000002,00BQ,Large City,2,50
1482,LCROS,18911,7387,11524,3296,15615,E07000125,E10000017,E12000002,30,"Above 10,000 (b)",7,30
1483,LCRUF,1376,772,604,548,828,E07000118,E10000017,E12000002,30,"Above 1,000 (b)",11,10
1484,LCRVW,376,176,200,125,251,E07000030,E10000006,E12000002,16,"Below 1,000 (b)",13,10
1485,LCSAM,1134,824,310,57,1077,E07000126,E10000017,E12000002,30,"Above 1,000 (b)",11,10
1486,LCSAT,312,106,206,43,269,E07000031,E10000006,E12000002,16,"Below 1,000 (b)",13,10
1487,LCSCA,1314,815,499,292,1022,E07000127,E10000017,E12000002,30,"Above 1,000 (b)",11,10
1488,LCSEA,933,926,7,846,87,E07000029,E10000006,E12000002,16,"Below 1,000 (b)",13,10
1489,LCSED,1525,1179,346,1035,490,E07000030,E10000006,E12000002,16,"Above 1,000 (b)",11,10
1490,LCSEG,2091,428,1663,192,1899,E07000031,E10000006,E12000002,16,"Above 1,000 (b)",11,10
1491,LCSEL,308,135,173,55,253,E07000031,E10000006,E12000002,16,"Below 1,000 (b)",13,10
1492,LCSHA,727,660,67,592,135,E07000030,E10000006,E12000002,16,"Below 1,000 (b)",13,10
1493,LCSHW,24114,12800,11314,6079,18035,E08000005,E99999999,E12000002,00BQ,Large City,2,50
1494,LCSIL,1708,1369,339,1056,652,E07000026,E10000006,E12000002,16,"Above 1,000 (a)",10,10
1495,LCSKE,408,219,189,146,262,E07000030,E10000006,E12000002,16,"Below 1,000 (b)",13,10
1496,LCSLA,327,135,192,106,221,E07000124,E10000017,E12000002,30,"Below 1,000 (b)",13,10
1497,LCSOU,13010,12262,748,7976,5034,E07000127,E10000017,E12000002,30,"Above 10,000 (b)",7,30
1498,LCSOW,820,228,592,79,741,E07000030,E10000006,E12000002,16,"Below 1,000 (b)",13,10
1499,LCSSH,14757,11565,3192,5324,9433,E06000009,E99999999,E12000002,00EY,Small City,3,50
1500,LCSTA,13305,12504,801,6005,7300,E06000009,E99999999,E12000002,00EY,Small City,3,50
1501,LCSTD,8876,7468,1408,3838,5038,E08000001,E99999999,E12000002,00BL,"Above 3,000 (b)",9,10
1502,LCSTM,518,276,242,192,326,E07000128,E10000017,E12000002,30,"Below 1,000 (a)",12,10
1503,LCSTO,992,506,486,175,817,E07000124,E10000017,E12000002,30,"Below 1,000 (b)",13,10
1504,LCSTV,1285,860,425,757,528,E07000031,E10000006,E12000002,16,"Above 1,000 (b)",11,10
1505,LCSVD,863,760,103,604,259,E07000121,E10000017,E12000002,30,"Below 1,000 (a)",12,10
1506,LCTHR,516,320,196,156,360,E07000030,E10000006,E12000002,16,"Below 1,000 (b)",13,10
1507,LCTOD,7825,5463,2362,3098,4727,E07000117,E10000017,E12000002,30,"Above 3,000 (b)",9,10
1508,LCTOT,9838,7369,2469,2672,7166,E08000001,E99999999,E12000002,00BL,"Above 3,000 (b)",9,10
1509,LCTUR,3097,1663,1434,493,2604,E06000008,E99999999,E12000002,00EX,"Above 3,000 (a)",8,30
1510,LCULV,7262,6640,622,3772,3490,E07000031,E10000006,E12000002,16,"Above 3,000 (a)",8,30
1511,LCWAL,6624,6373,251,3579,3045,E07000027,E10000006,E12000002,16,"Above 3,000 (b)",9,10
1512,LCWAS,137,43,94,0,137,E07000029,E10000006,E12000002,16,"Below 1,000 (b)",13,10
1513,LCWEE,901,304,597,124,777,E07000119,E10000017,E12000002,30,"Below 1,000 (b)",13,10
1514,LCWES,11888,10895,993,4701,7187,E08000001,E99999999,E12000002,00BL,Large City,2,50
1515,LCWET,3218,1059,2159,709,2509,E07000028,E10000006,E12000002,16,"Above 3,000 (b)",9,10
1516,LCWGT,3889,3086,803,2301,1588,E07000026,E10000006,E12000002,16,"Above 3,000 (b)",9,10
1517,LCWHA,3509,3054,455,1456,2053,E07000120,E10000017,E12000002,30,"Above 3,000 (b)",9,10
1518,LCWHI,13608,9000,4608,3903,9705,E07000029,E10000006,E12000002,16,"Above 10,000 (a)",6,30
1519,LCWHW,3866,3091,775,2017,1849,E07000125,E10000017,E12000002,30,"Above 3,000 (b)",9,10
1520,LCWIG,20322,17631,2691,4939,15383,E08000010,E99999999,E12000002,00BW,"Above 20,000 (a)",4,30
1521,LCWIL,7839,6051,1788,2124,5715,E06000008,E99999999,E12000002,00EX,"Above 3,000 (b)",9,10
1522,LCWIN,5295,4410,885,2798,2497,E07000031,E10000006,E12000002,16,"Above 3,000 (b)",9,10
1523,LCWOR,13230,9922,3308,6690,6540,E07000026,E10000006,E12000002,16,"Above 10,000 (b)",7,30
1524,LCWSK,439,221,218,135,304,E07000031,E10000006,E12000002,16,"Below 1,000 (b)",13,10
1525,LNADK,20829,19668,1161,9736,11093,E09000011,E99999999,E12000007,00London,Inner London,1,50
1526,LNBAR,27782,19497,8285,7951,19831,E07000098,E10000015,E12000006,26,"Above 20,000 (b)",5,30
1527,LNBGN,6971,5593,1378,3177,3794,E07000240,E10000015,E12000006,26,"Above 3,000 (b)",9,10
1528,LNBKG,29279,24487,4792,9793,19486,E09000002,E99999999,E12000007,00London,"Above 20,000 (b)",5,30
1529,LNBPK,24497,24497,0,12131,12366,E09000010,E99999999,E12000007,00London,"Above 20,000 (a)",4,30
1530,LNCED,17993,17830,163,11217,6776,E09000019,E99999999,E12000007,00London,Inner London,1,50
1531,LNCHF,18143,17620,523,6735,11408,E09000010,E99999999,E12000007,00London,"Above 10,000 (a)",6,30
1532,LNCLA,20210,20210,0,13663,6547,E09000012,E99999999,E12000007,00London,Inner London,1,50
1533,LNCNW,17303,17303,0,12298,5005,E09000028,E99999999,E12000007,00London,Inner London,1,50
1534,LNCUF,6834,3116,3718,1420,5414,E07000241,E10000015,E12000006,26,"Above 3,000 (b)",9,10
1535,LNDAG,35579,29172,6407,10216,25363,E09000016,E99999999,E12000007,00London,"Above 20,000 (b)",5,30
1536,LNDZ2,14946,14946,0,8656,6290,E09000023,E99999999,E12000007,00London,Inner London,1,50
1537,LNEDM,22289,22169,120,11337,10952,E09000010,E99999999,E12000007,00London,"Above 20,000 (a)",4,30
1538,LNENF,22913,19656,3257,7526,15387,E09000010,E99999999,E12000007,00London,"Above 20,000 (a)",4,30
1539,LNFIN,18247,18172,75,7707,10540,E09000003,E99999999,E12000007,00London,"Above 10,000 (a)",6,30
1540,LNGDM,38683,30771,7912,9371,29312,E09000002,E99999999,E12000007,00London,"Above 20,000 (b)",5,30
1541,LNGHL,17848,17759,89,7775,10073,E09000026,E99999999,E12000007,00London,"Above 10,000 (a)",6,30
1542,LNHAC,27351,27351,0,16405,10946,E09000030,E99999999,E12000007,00London,Inner London,1,50
1543,LNHAI,18118,14852,3266,6344,11774,E07000072,E10000012,E12000006,22,"Above 10,000 (a)",6,30
1544,LNHAT,17771,13523,4248,5880,11891,E07000240,E10000015,E12000006,26,"Above 10,000 (b)",7,30
1545,LNHOD,13305,8924,4381,3186,10119,E07000242,E10000015,E12000006,26,"Above 10,000 (b)",7,30
1546,LNHOR,20776,17365,3411,6144,14632,E09000016,E99999999,E12000007,00London,"Above 20,000 (a)",4,30
1547,LNHPK,24928,24766,162,8727,16201,E09000010,E99999999,E12000007,00London,"Above 20,000 (b)",5,30
1548,LNILC,17547,17467,80,9266,8281,E09000025,E99999999,E12000007,00London,Inner London,1,50
1549,LNILN,9388,9169,219,5690,3698,E09000025,E99999999,E12000007,00London,Inner London,1,50
1550,LNING,22959,20814,2145,6666,16293,E07000068,E10000012,E12000006,22,"Above 20,000 (b)",5,30
1551,LNLEY,22248,21619,629,12952,9296,E09000012,E99999999,E12000007,00London,Inner London,1,50
1552,LNLOU,15017,12883,2134,4355,10662,E07000072,E10000012,E12000006,22,"Above 10,000 (b)",7,30
1553,LNLVY,20944,11639,9305,2345,18599,E07000095,E10000015,E12000006,26,"Above 20,000 (a)",4,30
1554,LNMED,24732,24732,0,14573,10159,E09000030,E99999999,E12000007,00London,Inner London,1,50
1555,LNMUS,18467,18263,204,7030,11437,E09000014,E99999999,E12000007,00London,Inner London,1,50
1556,LNNAZ,2679,1372,1307,182,2497,E07000072,E10000012,E12000006,22,"Above 1,000 (b)",11,10
1557,LNNFN,16693,16364,329,8246,8447,E09000003,E99999999,E12000007,00London,"Above 10,000 (a)",6,30
1558,LNNWS,20900,18227,2673,6618,14282,E09000010,E99999999,E12000007,00London,"Above 20,000 (a)",4,30
1559,LNPFT,6482,6119,363,1288,5194,E09000004,E99999999,E12000007,00London,"Above 3,000 (b)",9,10
1560,LNPGN,15400,14033,1367,7513,7887,E09000010,E99999999,E12000007,00London,"Above 10,000 (a)",6,30
1561,LNPKS,6254,4591,1663,1607,4647,E07000240,E10000015,E12000006,26,"Above 3,000 (b)",9,10
1562,LNPON,25626,22293,3333,8417,17209,E09000010,E99999999,E12000007,00London,"Above 20,000 (a)",4,30
1563,LNPOT,13045,9047,3998,3681,9364,E07000098,E10000015,E12000006,26,"Above 10,000 (b)",7,30
1564,LNRAI,15196,12218,2978,4652,10544,E09000016,E99999999,E12000007,00London,"Above 10,000 (a)",6,30
1565,LNROD,210,161,49,76,134,E07000077,E10000012,E12000006,22,"Below 1,000 (b)",13,10
1566,LNROM,39812,23983,15829,8977,30835,E09000016,E99999999,E12000007,00London,"Above 20,000 (a)",4,30
1567,LNSFD,1258,244,1014,58,1200,E07000072,E10000012,E12000006,22,"Above 1,000 (b)",11,10
1568,LNSOK,9322,8781,541,5837,3485,E06000034,E99999999,E12000006,00KG,"Above 3,000 (b)",9,10
1569,LNSTA,24580,24580,0,13349,11231,E09000012,E99999999,E12000007,00London,Inner London,1,50
1570,LNSTB,29393,21342,8051,9510,19883,E07000240,E10000015,E12000006,26,"Above 20,000 (a)",4,30
1571,LNSTF,22908,21632,1276,6970,15938,E09000025,E99999999,E12000007,00London,Inner London,1,50
1572,LNTHB,4455,3052,1403,1543,2912,E07000072,E10000012,E12000006,22,"Above 3,000 (b)",9,10
1573,LNTOT,19494,19472,22,12371,7123,E09000031,E99999999,E12000007,00London,"Above 10,000 (a)",6,30
1574,LNUPK,42098,39080,3018,16340,25758,E09000025,E99999999,E12000007,00London,Inner London,1,50
1575,LNUPM,10741,10081,660,3840,6901,E07000068,E10000012,E12000006,22,"Above 10,000 (b)",7,30
1576,LNWCR,21247,10139,11108,4869,16378,E07000095,E10000015,E12000006,26,"Above 20,000 (a)",4,30
1577,LNWFD,22660,20371,2289,6430,16230,E07000072,E10000012,E12000006,22,"Above 20,000 (b)",5,30
1578,LNWGN,20671,13318,7353,3969,16702,E07000241,E10000015,E12000006,26,"Above 20,000 (b)",5,30
1579,LNWIN,11663,10229,1434,5810,5853,E09000010,E99999999,E12000007,00London,"Above 10,000 (a)",6,30
1580,LNWSD,15500,14891,609,6727,8773,E09000025,E99999999,E12000007,00London,Inner London,1,50
1581,LNWTH,24551,24551,0,13491,11060,E09000031,E99999999,E12000007,00London,"Above 20,000 (a)",4,30
1582,LSADD,25143,24087,1056,10519,14624,E09000006,E99999999,E12000007,00London,"Above 20,000 (b)",5,30
1583,LSASH,7096,6282,814,3324,3772,E07000210,E10000030,E12000008,43,"Above 3,000 (b)",9,10
1584,LSBAL,31825,31385,440,13303,18522,E09000024,E99999999,E12000007,00London,"Above 20,000 (a)",4,30
1585,LSBEC,19037,18449,588,8351,10686,E09000006,E99999999,E12000007,00London,"Above 10,000 (a)",6,30
1586,LSBET,2419,2025,394,356,2063,E07000211,E10000030,E12000008,43,"Above 1,000 (b)",11,10
1587,LSBEU,23391,23236,155,9847,13544,E09000006,E99999999,E12000007,00London,"Above 20,000 (a)",4,30
1588,LSBEX,25854,19374,6480,6591,19263,E09000004,E99999999,E12000007,00London,"Above 20,000 (b)",5,30
1589,LSBKM,7330,6831,499,3836,3494,E07000209,E10000030,E12000008,43,"Above 3,000 (b)",9,10
1590,LSBRO,20801,20704,97,9022,11779,E09000006,E99999999,E12000007,00London,"Above 20,000 (a)",4,30
1591,LSBURH,9337,8194,1143,3497,5840,E09000029,E99999999,E12000007,00London,"Above 3,000 (b)",9,10
1592,LSBYF,14308,10427,3881,2959,11349,E07000209,E10000030,E12000008,43,"Above 10,000 (b)",7,30
1593,LSCHER,8927,7158,1769,4356,4571,E07000212,E10000030,E12000008,43,"Above 3,000 (b)",9,10
1594,LSCHES,17089,15487,1602,6041,11048,E07000207,E10000030,E12000008,43,"Above 10,000 (a)",6,30
1595,LSCHI,13683,11537,2146,2612,11071,E09000006,E99999999,E12000007,00London,"Above 10,000 (a)",6,30
1596,LSCLPM,13944,13944,0,11790,2154,E09000022,E99999999,E12000007,00London,Inner London,1,50
1597,LSCOB,5791,4779,1012,2517,3274,E07000209,E10000030,E12000008,43,"Above 3,000 (b)",9,10
1598,LSCRAY,13392,10509,2883,3566,9826,E09000004,E99999999,E12000007,00London,"Above 10,000 (b)",7,30
1599,LSCRO,25559,25018,541,10820,14739,E09000008,E99999999,E12000007,00London,"Above 20,000 (a)",4,30
1600,LSCTFD,17459,17336,123,6188,11271,E09000006,E99999999,E12000007,00London,"Above 10,000 (a)",6,30
1601,LSCTHM,10623,7883,2740,3048,7575,E09000008,E99999999,E12000007,00London,"Above 10,000 (b)",7,30
1602,LSDAR,25946,20563,5383,7453,18493,E09000004,E99999999,E12000007,00London,"Above 20,000 (b)",5,30
1603,LSDEP,25448,25448,0,15282,10166,E09000023,E99999999,E12000007,00London,Inner London,1,50
1604,LSDOW,10582,7452,3130,1078,9504,E09000008,E99999999,E12000007,00London,"Above 10,000 (a)",6,30
1605,LSDUL,12511,12511,0,5946,6565,E09000023,E99999999,E12000007,00London,Inner London,1,50
1606,LSELT,17855,13594,4261,5954,11901,E09000011,E99999999,E12000007,00London,Inner London,1,50
1607,LSEPSM,14009,12906,1103,6943,7066,E07000211,E10000030,E12000008,43,"Above 10,000 (b)",7,30
1608,LSERI,16096,16032,64,7550,8546,E09000004,E99999999,E12000007,00London,"Above 10,000 (a)",6,30
1609,LSESH,5787,4992,795,2287,3500,E07000207,E10000030,E12000008,43,"Above 3,000 (a)",8,30
1610,LSEWE,11466,10780,686,4772,6694,E09000029,E99999999,E12000007,00London,"Above 10,000 (b)",7,30
1611,LSFARB,12184,9785,2399,2651,9533,E09000006,E99999999,E12000007,00London,"Above 10,000 (b)",7,30
1612,LSFARN,3974,1356,2618,474,3500,E07000111,E10000016,E12000008,29,"Above 3,000 (b)",9,10
1613,LSFOR,17546,17546,0,11382,6164,E09000023,E99999999,E12000007,00London,Inner London,1,50
1614,LSGIP,16046,16046,0,8386,7660,E09000008,E99999999,E12000007,00London,"Above 10,000 (a)",6,30
1615,LSGRNH,12303,8464,3839,4738,7565,E07000107,E10000016,E12000008,29,"Above 10,000 (a)",6,30
1616,LSGRNW,16314,15904,410,7733,8581,E09000023,E99999999,E12000007,00London,Inner London,1,50
1617,LSGRO,21286,20227,1059,6474,14812,E09000006,E99999999,E12000007,00London,"Above 20,000 (a)",4,30
1618,LSHAY,10789,9416,1373,3240,7549,E09000006,E99999999,E12000007,00London,"Above 10,000 (a)",6,30
1619,LSKID,17750,15982,1768,5310,12440,E09000011,E99999999,E12000007,00London,Inner London,1,50
1620,LSKIN,19101,18746,355,11272,7829,E09000021,E99999999,E12000007,00London,"Above 10,000 (a)",6,30
1621,LSLEA,7961,7651,310,3930,4031,E07000210,E10000030,E12000008,43,"Above 3,000 (b)",9,10
1622,LSLEE,21822,21789,33,11371,10451,E09000023,E99999999,E12000007,00London,Inner London,1,50
1623,LSLODH,12131,11644,487,5646,6485,E09000006,E99999999,E12000007,00London,"Above 10,000 (a)",6,30
1624,LSMAL,17100,16256,844,6792,10308,E09000024,E99999999,E12000007,00London,"Above 10,000 (a)",6,30
1625,LSMEPK,23695,21980,1715,9056,14639,E09000024,E99999999,E12000007,00London,"Above 20,000 (b)",5,30
1626,LSMERS,4486,4207,279,2238,2248,E07000215,E10000030,E12000008,43,"Above 3,000 (b)",9,10
1627,LSMIT,30591,24999,5592,9209,21382,E09000022,E99999999,E12000007,00London,Inner London,1,50
1628,LSMOG,2417,2011,406,795,1622,E07000211,E10000030,E12000008,43,"Above 1,000 (b)",11,10
1629,LSMOL,18326,15339,2987,3869,14457,E07000207,E10000030,E12000008,43,"Above 10,000 (a)",6,30
1630,LSMOR,19749,18019,1730,8949,10800,E09000032,E99999999,E12000007,00London,Inner London,1,50
1631,LSNCHM,20813,17584,3229,7880,12933,E09000029,E99999999,E12000007,00London,"Above 20,000 (a)",4,30
1632,LSNOR,18225,18037,188,8006,10219,E09000008,E99999999,E12000007,00London,"Above 10,000 (a)",6,30
1633,LSNUT,3205,1398,1807,814,2391,E07000215,E10000030,E12000008,43,"Above 3,000 (b)",9,10
1634,LSORP,25377,20422,4955,6327,19050,E09000006,E99999999,E12000007,00London,"Above 20,000 (b)",5,30
1635,LSOTT,5565,4097,1468,1431,4134,E07000217,E10000030,E12000008,43,"Above 3,000 (b)",9,10
1636,LSOXS,2710,2433,277,1111,1599,E07000207,E10000030,E12000008,43,"Above 1,000 (b)",11,10
1637,LSPUR,14539,12902,1637,4793,9746,E09000008,E99999999,E12000007,00London,"Above 10,000 (a)",6,30
1638,LSPUT,24385,21130,3255,10899,13486,E09000032,E99999999,E12000007,00London,Inner London,1,50
1639,LSRED,12100,11102,998,6868,5232,E07000211,E10000030,E12000008,43,"Above 10,000 (a)",6,30
1640,LSREI,11481,10191,1290,5337,6144,E07000211,E10000030,E12000008,43,"Above 10,000 (b)",7,30
1641,LSRIC,13904,13584,320,9138,4766,E09000027,E99999999,E12000007,00London,"Above 10,000 (a)",6,30
1642,LSRUS,13302,13302,0,7822,5480,E09000023,E99999999,E12000007,00London,Inner London,1,50
1643,LSSAN,13724,12710,1014,3010,10714,E09000008,E99999999,E12000007,00London,"Above 10,000 (b)",7,30
1644,LSSID,24233,17213,7020,7053,17180,E09000006,E99999999,E12000007,00London,"Above 20,000 (b)",5,30
1645,LSSLA,13890,13622,268,7111,6779,E09000004,E99999999,E12000007,00London,"Above 10,000 (b)",7,30
1646,LSSTR,17318,17257,61,10695,6623,E09000008,E99999999,E12000007,00London,"Above 10,000 (a)",6,30
1647,LSSUN,11922,10672,1250,4118,7804,E07000207,E10000030,E12000008,43,"Above 10,000 (a)",6,30
1648,LSSUR,16739,16521,218,11264,5475,E07000207,E10000030,E12000008,43,"Above 10,000 (a)",6,30
1649,LSSUT,26064,23281,2783,12348,13716,E09000029,E99999999,E12000007,00London,"Above 20,000 (a)",4,30
1650,LSSWA,10656,8998,1658,6035,4621,E09000006,E99999999,E12000007,00London,"Above 10,000 (b)",7,30
1651,LSSYD,21656,21601,55,10625,11031,E09000006,E99999999,E12000007,00London,"Above 20,000 (a)",4,30
1652,LSTAD,7116,6307,809,2667,4449,E07000211,E10000030,E12000008,43,"Above 3,000 (b)",9,10
1653,LSTED,14882,14822,60,7404,7478,E09000021,E99999999,E12000007,00London,"Above 10,000 (a)",6,30
1654,LSTHDT,9123,8661,462,4080,5043,E07000207,E10000030,E12000008,43,"Above 3,000 (a)",8,30
1655,LSTHMD,24090,20829,3261,8470,15620,E09000011,E99999999,E12000007,00London,Inner London,1,50
1656,LSTHO,22435,22373,62,11617,10818,E09000008,E99999999,E12000007,00London,"Above 20,000 (a)",4,30
1657,LSTUL,16885,16885,0,12264,4621,E09000022,E99999999,E12000007,00London,Inner London,1,50
1658,LSUWAR,7800,6898,902,2540,5260,E09000008,E99999999,E12000007,00London,"Above 3,000 (b)",9,10
1659,LSWAL,25638,22922,2716,9046,16592,E09000008,E99999999,E12000007,00London,"Above 20,000 (b)",5,30
1660,LSWAN,22983,20365,2618,10738,12245,E09000024,E99999999,E12000007,00London,"Above 20,000 (b)",5,30
1661,LSWEY,13749,10961,2788,3909,9840,E07000212,E10000030,E12000008,43,"Above 10,000 (a)",6,30
1662,LSWIM,16617,12877,3740,6376,10241,E09000024,E99999999,E12000007,00London,"Above 10,000 (b)",7,30
1663,LSWLTN,20631,14359,6272,4915,15716,E07000207,E10000030,E12000008,43,"Above 20,000 (a)",4,30
1664,LSWOL,806,783,23,521,285,E07000215,E10000030,E12000008,43,"Below 1,000 (a)",12,10
1665,LSWOO,30028,26820,3208,9464,20564,E09000011,E99999999,E12000007,00London,Inner London,1,50
1666,LSWOR,18441,17030,1411,7186,11255,E09000029,E99999999,E12000007,00London,"Above 10,000 (a)",6,30
1667,LSWWKM,12304,11621,683,5189,7115,E09000006,E99999999,E12000007,00London,"Above 10,000 (a)",6,30
1668,LVAIN,26074,19391,6683,7746,18328,E08000012,E99999999,E12000002,00BY,Large City,2,50
1669,LVALL,11135,11055,80,5764,5371,E08000012,E99999999,E12000002,00BY,Large City,2,50
1670,LVANF,19277,19277,0,10638,8639,E08000012,E99999999,E12000002,00BY,Large City,2,50
1671,LVARR,26896,18355,8541,4923,21973,E08000015,E99999999,E12000002,00CB,Small City,3,50
1672,LVAUG,3393,3034,359,1836,1557,E07000127,E10000017,E12000002,30,"Above 3,000 (b)",9,10
1673,LVBIL,6026,3391,2635,2231,3795,E08000010,E99999999,E12000002,00BW,"Above 3,000 (b)",9,10
1674,LVBIR,7043,7043,0,4614,2429,E08000015,E99999999,E12000002,00CB,Small City,3,50
1675,LVBOO,19743,19238,505,5976,13767,E08000012,E99999999,E12000002,00BY,Large City,2,50
1676,LVBRO,8646,7219,1427,3430,5216,E08000015,E99999999,E12000002,00CB,Small City,3,50
1677,LVCAL,7270,6594,676,4073,3197,E08000015,E99999999,E12000002,00CB,Small City,3,50
1678,LVCEN,3885,3885,0,2713,1172,E08000015,E99999999,E12000002,00CB,"Above 3,000 (b)",9,10
1679,LVCHI,13026,12382,644,6262,6764,E08000012,E99999999,E12000002,00BY,Large City,2,50
1680,LVCLA,16225,14757,1468,7854,8371,E08000015,E99999999,E12000002,00CB,Small City,3,50
1681,LVCRE,10776,10605,171,5325,5451,E08000012,E99999999,E12000002,00BY,Large City,2,50
1682,LVCUL,7762,3579,4183,2894,4868,E08000006,E99999999,E12000002,00BR,"Above 3,000 (b)",9,10
1683,LVEAS,8851,7695,1156,4062,4789,E06000050,E99999999,E12000002,00EW,"Above 3,000 (b)",9,10
1684,LVELL,12757,9681,3076,4032,8725,E06000050,E99999999,E12000002,00EW,"Above 10,000 (b)",7,30
1685,LVFRO,4543,4472,71,2424,2119,E06000050,E99999999,E12000002,00EW,"Above 3,000 (b)",9,10
1686,LVGAT,9740,9740,0,5577,4163,E08000012,E99999999,E12000002,00BY,"Above 3,000 (b)",9,10
1687,LVGRE,12872,10792,2080,6418,6454,E08000014,E99999999,E12000002,00CA,"Above 10,000 (a)",6,30
1688,LVHAL,4925,3416,1509,711,4214,E08000012,E99999999,E12000002,00BY,"Above 3,000 (b)",9,10
1689,LVHEL,4565,2654,1911,1881,2684,E06000050,E99999999,E12000002,00EW,"Above 3,000 (b)",9,10
1690,LVHES,7528,7274,254,3902,3626,E06000050,E99999999,E12000002,00EW,"Above 3,000 (b)",9,10
1691,LVHIG,1231,1011,220,720,511,E07000127,E10000017,E12000002,30,"Above 1,000 (b)",11,10
1692,LVHOO,15310,12401,2909,5280,10030,E06000050,E99999999,E12000002,00EW,"Above 10,000 (b)",7,30
1693,LVHOY,6102,4806,1296,3245,2857,E08000015,E99999999,E12000002,00CB,"Above 3,000 (b)",9,10
1694,LVHUN,14418,11802,2616,3545,10873,E08000012,E99999999,E12000002,00BY,Large City,2,50
1695,LVHUY,25258,17703,7555,5755,19503,E08000012,E99999999,E12000002,00BY,Large City,2,50
1696,LVIRB,6937,6650,287,3631,3306,E08000015,E99999999,E12000002,00CB,Small City,3,50
1697,LVKIN,1557,865,692,568,989,E06000050,E99999999,E12000002,00EW,"Above 1,000 (b)",11,10
1698,LVLAR,13473,13419,54,6756,6717,E08000012,E99999999,E12000002,00BY,Large City,2,50
1699,LVLYM,6651,5262,1389,2186,4465,E06000049,E99999999,E12000002,00EQ,"Above 3,000 (b)",9,10
1700,LVMAG,20222,10656,9566,4352,15870,E07000127,E10000017,E12000002,30,"Above 20,000 (b)",5,30
1701,LVMAN,516,326,190,172,344,E06000050,E99999999,E12000002,00EW,"Below 1,000 (b)",13,10
1702,LVMOO,901,841,60,515,386,E06000006,E99999999,E12000002,00ET,"Below 1,000 (b)",13,10
1703,LVMOU,9864,9599,265,5613,4251,E08000015,E99999999,E12000002,00CB,Small City,3,50
1704,LVMPK,4350,4117,233,1502,2848,E06000006,E99999999,E12000002,00ET,"Above 3,000 (b)",9,10
1705,LVMSX,16917,11276,5641,4398,12519,E06000006,E99999999,E12000002,00ET,"Above 10,000 (b)",7,30
1706,LVNCB,1299,466,833,100,1199,E06000050,E99999999,E12000002,00EW,"Above 1,000 (b)",11,10
1707,LVNES,8265,6975,1290,3401,4864,E06000050,E99999999,E12000002,00EW,"Above 3,000 (b)",9,10
1708,LVNET,6374,5737,637,3620,2754,E08000012,E99999999,E12000002,00BY,"Above 3,000 (b)",9,10
1709,LVNLW,20323,10613,9710,5097,15226,E08000010,E99999999,E12000002,00BW,"Above 20,000 (a)",4,30
1710,LVNOR,6179,6179,0,4363,1816,E08000012,E99999999,E12000002,00BY,"Above 3,000 (b)",9,10
1711,LVORM,8766,8243,523,4914,3852,E07000127,E10000017,E12000002,30,"Above 3,000 (b)",9,10
1712,LVPAD,20412,15907,4505,5519,14893,E06000007,E99999999,E12000002,00EU,"Above 20,000 (a)",4,30
1713,LVPADPK,6469,5579,890,2877,3592,E06000007,E99999999,E12000002,00EU,"Above 3,000 (b)",9,10
1714,LVPEN,9607,8860,747,3957,5650,E06000006,E99999999,E12000002,00ET,"Above 3,000 (b)",9,10
1715,LVPRE,17623,11623,6000,5181,12442,E08000011,E99999999,E12000002,00BX,Large City,2,50
1716,LVRAI,4068,2929,1139,1667,2401,E07000127,E10000017,E12000002,30,"Above 3,000 (b)",9,10
1717,LVRNE,12073,11327,746,4425,7648,E06000050,E99999999,E12000002,00EW,"Above 10,000 (b)",7,30
1718,LVRNM,13175,11743,1432,5255,7920,E06000006,E99999999,E12000002,00ET,"Above 10,000 (a)",6,30
1719,LVROC,16993,15365,1628,7843,9150,E08000015,E99999999,E12000002,00CB,Small City,3,50
1720,LVROY,13392,13336,56,6957,6435,E08000012,E99999999,E12000002,00BY,Large City,2,50
1721,LVSAI,35176,17405,17771,4808,30368,E08000013,E99999999,E12000002,00BZ,"Above 20,000 (a)",4,30
1722,LVSEF,15318,15318,0,11243,4075,E08000012,E99999999,E12000002,00BY,Large City,2,50
1723,LVSIM,26575,9453,17122,2950,23625,E08000012,E99999999,E12000002,00BY,Large City,2,50
1724,LVSKE,14189,9751,4438,3969,10220,E07000127,E10000017,E12000002,30,"Above 10,000 (b)",7,30
1725,LVSTA,25348,21653,3695,8186,17162,E08000012,E99999999,E12000002,00BY,Large City,2,50
1726,LVSTK,16841,10131,6710,5901,10940,E06000007,E99999999,E12000002,00EU,"Above 10,000 (b)",7,30
1727,LVSTO,25895,18876,7019,8982,16913,E08000012,E99999999,E12000002,00BY,Large City,2,50
1728,LVUPH,10002,7907,2095,2756,7246,E08000010,E99999999,E12000002,00BW,"Above 10,000 (a)",6,30
1729,LVWAL,28705,26273,2432,10199,18506,E08000015,E99999999,E12000002,00CB,Small City,3,50
1730,LVWAR,11668,11032,636,4319,7349,E06000007,E99999999,E12000002,00EU,"Above 10,000 (a)",6,30
1731,LVWAT,19890,16099,3791,6572,13318,E08000014,E99999999,E12000002,00CA,"Above 10,000 (b)",7,30
1732,LVWID,26913,11556,15357,4906,22007,E06000006,E99999999,E12000002,00ET,"Above 20,000 (a)",4,30
1733,LVWTW,16815,14084,2731,5137,11678,E06000007,E99999999,E12000002,00EU,"Above 10,000 (a)",6,30
1734,LWACT,19520,19418,102,10170,9350,E09000005,E99999999,E12000007,00London,"Above 10,000 (b)",7,30
1735,LWASF,18260,13962,4298,5333,12927,E09000017,E99999999,E12000007,00London,"Above 10,000 (b)",7,30
1736,LWBUS,9509,8345,1164,4564,4945,E07000098,E10000015,E12000006,26,"Above 3,000 (b)",9,10
1737,LWCHI,22771,21705,1066,10925,11846,E09000009,E99999999,E12000007,00London,"Above 20,000 (a)",4,30
1738,LWCHO,3802,3160,642,2140,1662,E07000102,E10000015,E12000006,26,"Above 3,000 (b)",9,10
1739,LWCOL,14684,13357,1327,5707,8977,E09000003,E99999999,E12000007,00London,"Above 10,000 (a)",6,30
1740,LWCRI,13505,13360,145,8105,5400,E09000007,E99999999,E12000007,00London,Inner London,1,50
1741,LWDEN,2716,2464,252,675,2041,E09000017,E99999999,E12000007,00London,"Above 1,000 (b)",11,10
1742,LWEAL,25406,22878,2528,8433,16973,E09000009,E99999999,E12000007,00London,"Above 20,000 (a)",4,30
1743,LWEDG,13782,13782,0,7378,6404,E09000003,E99999999,E12000007,00London,"Above 10,000 (a)",6,30
1744,LWEGH,9171,8225,946,3594,5577,E07000212,E10000030,E12000008,43,"Above 3,000 (b)",9,10
1745,LWELS,16711,14981,1730,5291,11420,E07000098,E10000015,E12000006,26,"Above 10,000 (b)",7,30
1746,LWFEL,23219,18827,4392,6113,17106,E09000027,E99999999,E12000007,00London,"Above 20,000 (b)",5,30
1747,LWGAR,21802,17796,4006,6179,15623,E07000240,E10000015,E12000006,26,"Above 20,000 (b)",5,30
1748,LWGOL,13987,13850,137,7688,6299,E09000014,E99999999,E12000007,00London,Inner London,1,50
1749,LWGRE,19653,18197,1456,6961,12692,E09000009,E99999999,E12000007,00London,"Above 10,000 (a)",6,30
1750,LWHAM,14178,14178,0,9804,4374,E09000027,E99999999,E12000007,00London,"Above 10,000 (a)",6,30
1751,LWHARE,4207,3356,851,2128,2079,E07000102,E10000015,E12000006,26,"Above 3,000 (b)",9,10
1752,LWHARL,15825,15403,422,7624,8201,E09000005,E99999999,E12000007,00London,"Above 10,000 (b)",7,30
1753,LWHARR,21521,21172,349,9730,11791,E09000015,E99999999,E12000007,00London,"Above 20,000 (a)",4,30
1754,LWHAT,16691,13112,3579,3676,13015,E07000102,E10000015,E12000006,26,"Above 10,000 (b)",7,30
1755,LWHAY,23364,18381,4983,7031,16333,E09000009,E99999999,E12000007,00London,"Above 20,000 (a)",4,30
1756,LWHEN,11335,11335,0,7060,4275,E09000003,E99999999,E12000007,00London,"Above 10,000 (a)",6,30
1757,LWHOU,26513,21048,5465,8894,17619,E09000018,E99999999,E12000007,00London,"Above 20,000 (a)",4,30
1758,LWISL,16318,14946,1372,6569,9749,E09000009,E99999999,E12000007,00London,"Above 10,000 (b)",7,30
1759,LWKGRE,20387,20387,0,14071,6316,E09000033,E99999999,E12000007,00London,Inner London,1,50
1760,LWKIN,10514,10514,0,5640,4874,E09000005,E99999999,E12000007,00London,"Above 10,000 (a)",6,30
1761,LWKLAN,8920,4665,4255,2508,6412,E07000240,E10000015,E12000006,26,"Above 3,000 (b)",9,10
1762,LWKNE,16160,15810,350,7758,8402,E09000027,E99999999,E12000007,00London,"Above 10,000 (b)",7,30
1763,LWKROA,12957,12957,0,6534,6423,E09000005,E99999999,E12000007,00London,"Above 10,000 (a)",6,30
1764,LWMIL,13332,13027,305,5510,7822,E09000003,E99999999,E12000007,00London,"Above 10,000 (b)",7,30
1765,LWNEDG,7473,7472,1,5486,1987,E09000003,E99999999,E12000007,00London,"Above 3,000 (b)",9,10
1766,LWNOR,18827,15707,3120,8148,10679,E09000009,E99999999,E12000007,00London,"Above 10,000 (a)",6,30
1767,LWNWEM,13499,12564,935,6334,7165,E09000005,E99999999,E12000007,00London,"Above 10,000 (a)",6,30
1768,LWNWOO,11973,10008,1965,4907,7066,E07000102,E10000015,E12000006,26,"Above 10,000 (a)",6,30
1769,LWPER,15283,14682,601,7167,8116,E09000005,E99999999,E12000007,00London,"Above 10,000 (a)",6,30
1770,LWPIN,22591,19931,2660,6431,16160,E09000009,E99999999,E12000007,00London,"Above 20,000 (b)",5,30
1771,LWRAD,5488,3793,1695,2530,2958,E07000240,E10000015,E12000006,26,"Above 3,000 (b)",9,10
1772,LWRIC,11861,8186,3675,3316,8545,E07000102,E10000015,E12000006,26,"Above 10,000 (b)",7,30
1773,LWRUI,18434,15466,2968,5026,13408,E09000017,E99999999,E12000007,00London,"Above 10,000 (a)",6,30
1774,LWSHAR,23395,18524,4871,7459,15936,E09000005,E99999999,E12000007,00London,"Above 20,000 (b)",5,30
1775,LWSHE,22713,22574,139,12058,10655,E09000009,E99999999,E12000007,00London,"Above 20,000 (a)",4,30
1776,LWSKY,9622,6010,3612,2046,7576,E09000017,E99999999,E12000007,00London,"Above 3,000 (b)",9,10
1777,LWSOU,19736,17687,2049,7980,11756,E09000009,E99999999,E12000007,00London,"Above 10,000 (a)",6,30
1778,LWSTAI,11902,10273,1629,4081,7821,E07000212,E10000030,E12000008,43,"Above 10,000 (b)",7,30
1779,LWSTAN,12487,11991,496,5282,7205,E07000098,E10000015,E12000006,26,"Above 10,000 (b)",7,30
1780,LWTWI,14810,14779,31,7571,7239,E09000027,E99999999,E12000007,00London,"Above 10,000 (a)",6,30
1781,LWUXB,17739,10105,7634,5089,12650,E09000017,E99999999,E12000007,00London,"Above 10,000 (a)",6,30
1782,LWWAT,28909,23957,4952,9033,19876,E07000098,E10000015,E12000006,26,"Above 20,000 (a)",4,30
1783,LWWDRA,17056,13652,3404,6708,10348,E09000017,E99999999,E12000007,00London,"Above 10,000 (b)",7,30
1784,LWWEM,23699,21520,2179,8097,15602,E09000005,E99999999,E12000007,00London,"Above 20,000 (a)",4,30
1785,LWWIL,16724,15457,1267,9151,7573,E09000005,E99999999,E12000007,00London,"Above 10,000 (a)",6,30
1786,LWWRA,3757,3227,530,1104,2653,E07000212,E10000030,E12000008,43,"Above 3,000 (b)",9,10
1787,MRALD,4067,3358,709,2302,1765,E06000049,E99999999,E12000002,00EQ,"Above 3,000 (b)",9,10
1788,MRALT,16899,13037,3862,5279,11620,E06000049,E99999999,E12000002,00EQ,"Above 10,000 (b)",7,30
1789,MRARD,6155,6155,0,3961,2194,E08000003,E99999999,E12000002,00BN,"Above 3,000 (a)",8,30
1790,MRARL,374,121,253,58,316,E06000050,E99999999,E12000002,00EW,"Below 1,000 (b)",13,10
1791,MRASH,26053,22735,3318,7396,18657,E08000004,E99999999,E12000002,00BP,Large City,2,50
1792,MRBLA,6575,6575,0,3758,2817,E08000006,E99999999,E12000002,00BR,"Above 3,000 (a)",8,30
1793,MRBOL,4887,4136,751,2195,2692,E06000049,E99999999,E12000002,00EQ,"Above 3,000 (b)",9,10
1794,MRBRA,9452,8975,477,3725,5727,E06000049,E99999999,E12000002,00EQ,"Above 3,000 (b)",9,10
1795,MRBRO,10957,10957,0,7267,3690,E08000006,E99999999,E12000002,00BR,Large City,2,50
1796,MRBUC,975,399,576,154,821,E06000049,E99999999,E12000002,00EQ,"Below 1,000 (b)",13,10
1797,MRBUR,26911,19631,7280,5186,21725,E07000125,E10000017,E12000002,30,"Above 20,000 (b)",5,30
1798,MRBUX,11229,8957,2272,4723,6506,E07000198,E10000028,E12000005,41,"Above 10,000 (b)",7,30
1799,MRCEN,7574,7574,0,6045,1529,E08000003,E99999999,E12000002,00BN,"Above 3,000 (a)",8,30
1800,MRCHA,4104,3360,744,3053,1051,E07000037,E10000007,E12000004,17,"Above 3,000 (b)",9,10
1801,MRCHE,16652,13884,2768,7229,9423,E08000002,E99999999,E12000002,00BM,Large City,2,50
1802,MRCHI,1387,1149,238,876,511,E07000037,E10000007,E12000004,17,"Above 1,000 (b)",11,10
1803,MRCHL,1315,708,607,107,1208,E06000049,E99999999,E12000002,00EQ,"Above 1,000 (b)",11,10
1804,MRCHO,15510,15284,226,9821,5689,E08000003,E99999999,E12000002,00BN,Large City,2,50
1805,MRCOL,12079,10247,1832,4710,7369,E08000003,E99999999,E12000002,00BN,Large City,2,50
1806,MRCOM,2359,1373,986,440,1919,E06000050,E99999999,E12000002,00EW,"Above 1,000 (b)",11,10
1807,MRCON,13735,11206,2529,4210,9525,E06000049,E99999999,E12000002,00EQ,"Above 10,000 (a)",6,30
1808,MRDEN,17478,14349,3129,7356,10122,E08000008,E99999999,E12000002,00BT,Large City,2,50
1809,MRDID,23119,23034,85,9292,13827,E08000003,E99999999,E12000002,00BN,Large City,2,50
1810,MRDIS,4285,3593,692,1300,2985,E06000049,E99999999,E12000002,00EQ,"Above 3,000 (b)",9,10
1811,MRDRO,26468,20860,5608,7137,19331,E08000003,E99999999,E12000002,00BN,Large City,2,50
1812,MREAS,12361,10831,1530,3662,8699,E08000003,E99999999,E12000002,00BN,Large City,2,50
1813,MRECC,22279,17864,4415,7040,15239,E08000006,E99999999,E12000002,00BR,Large City,2,50
1814,MRFAI,30543,24492,6051,6465,24078,E08000004,E99999999,E12000002,00BP,Large City,2,50
1815,MRGAT,12161,11996,165,3855,8306,E08000003,E99999999,E12000002,00BN,Large City,2,50
1816,MRGLO,11708,8459,3249,5239,6469,E07000037,E10000007,E12000004,17,"Above 10,000 (b)",7,30
1817,MRHAR,12772,9550,3222,4014,8758,E06000050,E99999999,E12000002,00EW,"Above 10,000 (b)",7,30
1818,MRHEA,26880,20058,6822,6308,20572,E08000003,E99999999,E12000002,00BN,Large City,2,50
1819,MRHTN,625,223,402,158,467,E07000198,E10000028,E12000005,41,"Below 1,000 (b)",13,10
1820,MRHUL,11501,11065,436,5236,6265,E06000049,E99999999,E12000002,00EQ,"Above 10,000 (b)",7,30
1821,MRHYD,18676,17656,1020,5738,12938,E08000008,E99999999,E12000002,00BT,Large City,2,50
1822,MRIRL,15892,8376,7516,2153,13739,E08000006,E99999999,E12000002,00BR,Large City,2,50
1823,MRKNU,6947,6594,353,3479,3468,E06000049,E99999999,E12000002,00EQ,"Above 3,000 (a)",8,30
1824,MRLNR,682,289,393,202,480,E07000198,E10000028,E12000005,41,"Below 1,000 (b)",13,10
1825,MRLON,10188,10116,72,6018,4170,E08000003,E99999999,E12000002,00BN,Large City,2,50
1826,MRLOW,1046,393,653,83,963,E06000050,E99999999,E12000002,00EW,"Above 1,000 (b)",11,10
1827,MRMAC,22251,17677,4574,7391,14860,E06000049,E99999999,E12000002,00EQ,"Above 20,000 (a)",4,30
1828,MRMAR,9998,8371,1627,4429,5569,E08000007,E99999999,E12000002,00BS,"Above 3,000 (b)",9,10
1829,MRMDW,12217,5982,6235,3784,8433,E06000050,E99999999,E12000002,00EW,"Above 10,000 (a)",6,30
1830,MRMER,18330,11740,6590,3568,14762,E06000049,E99999999,E12000002,00EQ,"Above 10,000 (a)",6,30
1831,MRMHE,404,121,283,71,333,E06000049,E99999999,E12000002,00EQ,"Below 1,000 (b)",13,10
1832,MRMID,32108,20924,11184,4866,27242,E08000002,E99999999,E12000002,00BM,Large City,2,50
1833,MRMOB,1638,1285,353,401,1237,E06000049,E99999999,E12000002,00EQ,"Above 1,000 (b)",11,10
1834,MRMOS,17411,17411,0,9824,7587,E08000003,E99999999,E12000002,00BN,Large City,2,50
1835,MRMOT,10486,6072,4414,1532,8954,E07000037,E10000007,E12000004,17,"Above 10,000 (b)",7,30
1836,MRMSL,11011,8031,2980,3340,7671,E08000004,E99999999,E12000002,00BP,Large City,2,50
1837,MRNEW,6361,4820,1541,3279,3082,E06000049,E99999999,E12000002,00EQ,"Above 3,000 (b)",9,10
1838,MRNOR,7112,6768,344,3580,3532,E06000050,E99999999,E12000002,00EW,"Above 3,000 (b)",9,10
1839,MRNRD,562,252,310,49,513,E06000049,E99999999,E12000002,00EQ,"Below 1,000 (b)",13,10
1840,MROLD,50656,27383,23273,6113,44543,E08000004,E99999999,E12000002,00BP,Large City,2,50
1841,MRPBY,3806,2758,1048,1030,2776,E06000049,E99999999,E12000002,00EQ,"Above 3,000 (b)",9,10
1842,MRPEN,14747,14729,18,6595,8152,E08000006,E99999999,E12000002,00BR,Large City,2,50
1843,MRPIC,2316,1746,570,900,1416,E06000050,E99999999,E12000002,00EW,"Above 1,000 (b)",11,10
1844,MRPOY,9609,8062,1547,2664,6945,E06000049,E99999999,E12000002,00EQ,"Above 3,000 (b)",9,10
1845,MRPRE,11360,11296,64,5629,5731,E08000002,E99999999,E12000002,00BM,Large City,2,50
1846,MRRAD,16753,13356,3397,5184,11569,E08000001,E99999999,E12000002,00BL,Large City,2,50
1847,MRRIN,16026,9356,6670,3058,12968,E06000049,E99999999,E12000002,00EQ,"Above 10,000 (b)",7,30
1848,MRRSP,362,213,149,147,215,E06000049,E99999999,E12000002,00EQ,"Below 1,000 (b)",13,10
1849,MRRUS,25501,22388,3113,8915,16586,E08000003,E99999999,E12000002,00BN,Large City,2,50
1850,MRSAD,8647,4700,3947,1901,6746,E08000034,E99999999,E12000003,00CZ,"Above 3,000 (b)",9,10
1851,MRSAL,30101,20870,9231,8199,21902,E08000003,E99999999,E12000002,00BN,Large City,2,50
1852,MRSAN,3566,2473,1093,1664,1902,E06000050,E99999999,E12000002,00EW,"Above 3,000 (b)",9,10
1853,MRSTA,14027,13734,293,5921,8106,E08000008,E99999999,E12000002,00BT,Large City,2,50
1854,MRSTE,22371,19871,2500,6895,15476,E08000007,E99999999,E12000002,00BS,Large City,2,50
1855,MRSTO,18893,18384,509,6091,12802,E08000007,E99999999,E12000002,00BS,Large City,2,50
1856,MRSUT,3297,2694,603,740,2557,E06000049,E99999999,E12000002,00EQ,"Above 3,000 (b)",9,10
1857,MRSWI,20804,19228,1576,7076,13728,E08000001,E99999999,E12000002,00BL,Large City,2,50
1858,MRTAD,774,226,548,160,614,E07000035,E10000007,E12000004,17,"Below 1,000 (b)",13,10
1859,MRTID,1567,1081,486,915,652,E07000035,E10000007,E12000004,17,"Above 1,000 (b)",11,10
1860,MRTRA,8971,8905,66,3139,5832,E08000006,E99999999,E12000002,00BR,"Above 3,000 (b)",9,10
1861,MRURM,18151,14206,3945,5322,12829,E08000006,E99999999,E12000002,00BR,Large City,2,50
1862,MRWAL,22671,13516,9155,5973,16698,E08000001,E99999999,E12000002,00BL,Large City,2,50
1863,MRWEA,4573,3555,1018,2460,2113,E06000050,E99999999,E12000002,00EW,"Above 3,000 (b)",9,10
1864,MRWHA,3425,3064,361,1620,1805,E06000049,E99999999,E12000002,00EQ,"Above 3,000 (b)",9,10
1865,MRWHI,17412,15755,1657,5407,12005,E08000002,E99999999,E12000002,00BM,Large City,2,50
1866,MRWIL,12952,10588,2364,4167,8785,E06000049,E99999999,E12000002,00EQ,"Above 10,000 (b)",7,30
1867,MRWNC,372,122,250,40,332,E06000049,E99999999,E12000002,00EQ,"Below 1,000 (b)",13,10
1868,MRWOO,16368,14390,1978,4932,11436,E08000008,E99999999,E12000002,00BT,Large City,2,50
1869,MRWYT,21030,12655,8375,3714,17316,E08000003,E99999999,E12000002,00BN,Large City,2,50
1870,MYACO,16668,15679,989,7269,9399,E06000014,E99999999,E12000003,00FF,"Above 10,000 (b)",7,30
1871,MYADD,1981,1605,376,312,1669,E08000032,E99999999,E12000003,00CX,"Above 1,000 (b)",11,10
1872,MYADE,13082,9475,3607,2973,10109,E08000035,E99999999,E12000003,00DA,Large City,2,50
1873,MYAIR,407,187,220,46,361,E07000163,E10000023,E12000003,36,"Below 1,000 (b)",13,10
1874,MYALD,1373,576,797,487,886,E06000011,E99999999,E12000003,00FB,"Above 1,000 (b)",11,10
1875,MYAMP,672,257,415,15,657,E07000167,E10000023,E12000003,36,"Below 1,000 (b)",13,10
1876,MYAPP,1280,349,931,310,970,E07000169,E10000023,E12000003,36,"Above 1,000 (b)",11,10
1877,MYARM,21819,16395,5424,7564,14255,E08000035,E99999999,E12000003,00DA,Large City,2,50
1878,MYARN,150,44,106,22,128,E07000163,E10000023,E12000003,36,"Below 1,000 (b)",13,10
1879,MYART,2882,2137,745,896,1986,E08000035,E99999999,E12000003,00DA,"Above 1,000 (b)",11,10
1880,MYBAG,588,179,409,100,488,E06000011,E99999999,E12000003,00FB,"Below 1,000 (b)",13,10
1881,MYBAT,14893,12238,2655,5680,9213,E08000035,E99999999,E12000003,00DA,Large City,2,50
1882,MYBBY,334,120,214,58,276,E07000164,E10000023,E12000003,36,"Below 1,000 (b)",13,10
1883,MYBD,11175,10938,237,5308,5867,E08000032,E99999999,E12000003,00CX,"Above 10,000 (a)",6,30
1884,MYBEE,1115,746,369,247,868,E06000011,E99999999,E12000003,00FB,"Above 1,000 (b)",11,10
1885,MYBEN,744,322,422,286,458,E07000165,E10000023,E12000003,36,"Below 1,000 (b)",13,10
1886,MYBIL,276,21,255,6,270,E07000164,E10000023,E12000003,36,"Below 1,000 (b)",13,10
1887,MYBIN,13329,10378,2951,4444,8885,E08000032,E99999999,E12000003,00CX,"Above 10,000 (b)",7,30
1888,MYBIR,1782,753,1029,200,1582,E07000165,E10000023,E12000003,36,"Above 1,000 (b)",11,10
1889,MYBKA,1812,579,1233,234,1578,E08000035,E99999999,E12000003,00DA,"Above 1,000 (b)",11,10
1890,MYBKE,2618,1401,1217,1139,1479,E08000035,E99999999,E12000003,00DA,"Above 1,000 (b)",11,10
1891,MYBLU,352,73,279,21,331,E07000165,E10000023,E12000003,36,"Below 1,000 (b)",13,10
1892,MYBNN,18582,14726,3856,6883,11699,E06000011,E99999999,E12000003,00FB,"Above 10,000 (b)",7,30
1893,MYBNS,367,209,158,60,307,E07000163,E10000023,E12000003,36,"Below 1,000 (b)",13,10
1894,MYBOL,388,141,247,44,344,E07000163,E10000023,E12000003,36,"Below 1,000 (b)",13,10
1895,MYBOR,3187,2107,1080,1490,1697,E07000165,E10000023,E12000003,36,"Above 3,000 (b)",9,10
1896,MYBOS,4493,3344,1149,1740,2753,E08000035,E99999999,E12000003,00DA,"Above 3,000 (b)",9,10
1897,MYBPI,1272,457,815,336,936,E06000011,E99999999,E12000003,00FB,"Above 1,000 (b)",11,10
1898,MYBPM,1188,428,760,307,881,E07000165,E10000023,E12000003,36,"Above 1,000 (b)",11,10
1899,MYBPW,617,226,391,196,421,E07000167,E10000023,E12000003,36,"Below 1,000 (b)",13,10
1900,MYBRE,2272,336,1936,199,2073,E08000034,E99999999,E12000003,00CZ,"Above 1,000 (b)",11,10
1901,MYBRG,13637,9569,4068,4373,9264,E08000033,E99999999,E12000003,00CY,"Above 10,000 (b)",7,30
1902,MYBRN,1492,296,1196,170,1322,E07000169,E10000023,E12000003,36,"Above 1,000 (b)",11,10
1903,MYBRW,3746,3232,514,2734,1012,E08000032,E99999999,E12000003,00CX,"Above 3,000 (b)",9,10
1904,MYBUB,1383,454,929,395,988,E06000011,E99999999,E12000003,00FB,"Above 1,000 (b)",11,10
1905,MYBYP,600,142,458,83,517,E07000167,E10000023,E12000003,36,"Below 1,000 (b)",13,10
1906,MYCAL,4312,2658,1654,2053,2259,E08000033,E99999999,E12000003,00CY,"Above 3,000 (b)",9,10
1907,MYCAM,1771,1168,603,470,1301,E07000169,E10000023,E12000003,36,"Above 1,000 (b)",11,10
1908,MYCAS,23203,13012,10191,5288,17915,E08000035,E99999999,E12000003,00DA,Large City,2,50
1909,MYCAW,1540,856,684,607,933,E07000169,E10000023,E12000003,36,"Above 1,000 (b)",11,10
1910,MYCAY,7300,5673,1627,2812,4488,E07000167,E10000023,E12000003,36,"Above 3,000 (b)",9,10
1911,MYCHA,16234,15652,582,8437,7797,E08000035,E99999999,E12000003,00DA,Large City,2,50
1912,MYCLE,13506,10744,2762,4851,8655,E08000034,E99999999,E12000003,00CZ,"Above 10,000 (b)",7,30
1913,MYCLO,2156,1074,1082,741,1415,E07000168,E10000023,E12000003,36,"Above 1,000 (b)",11,10
1914,MYCOL,2478,1873,605,475,2003,E08000035,E99999999,E12000003,00DA,"Above 1,000 (b)",11,10
1915,MYCON,491,60,431,40,451,E07000167,E10000023,E12000003,36,"Below 1,000 (b)",13,10
1916,MYCOP,689,299,390,190,499,E07000165,E10000023,E12000003,36,"Below 1,000 (b)",13,10
1917,MYCOX,547,128,419,100,447,E07000164,E10000023,E12000003,36,"Below 1,000 (b)",13,10
1918,MYCRA,260,204,56,79,181,E07000163,E10000023,E12000003,36,"Below 1,000 (b)",13,10
1919,MYCRF,5337,3784,1553,1914,3423,E08000036,E99999999,E12000003,00DB,"Above 3,000 (b)",9,10
1920,MYCSG,16992,15796,1196,6213,10779,E08000035,E99999999,E12000003,00DA,Large City,2,50
1921,MYCSH,6405,4483,1922,2742,3663,E07000163,E10000023,E12000003,36,"Above 3,000 (a)",8,30
1922,MYCTN,12327,10501,1826,4460,7867,E06000014,E99999999,E12000003,00FF,"Above 10,000 (b)",7,30
1923,MYCUL,5336,2446,2890,1366,3970,E08000032,E99999999,E12000003,00CX,"Above 3,000 (b)",9,10
1924,MYDAL,522,94,428,56,466,E06000011,E99999999,E12000003,00FB,"Below 1,000 (b)",13,10
1925,MYDAR,1223,751,472,97,1126,E07000165,E10000023,E12000003,36,"Above 1,000 (b)",11,10
1926,MYDEW,21081,14891,6190,4491,16590,E08000035,E99999999,E12000003,00DA,Large City,2,50
1927,MYDFF,8105,6377,1728,4144,3961,E06000011,E99999999,E12000003,00FB,"Above 3,000 (b)",9,10
1928,MYDHS,11358,7921,3437,3352,8006,E07000169,E10000023,E12000003,36,"Above 10,000 (b)",7,30
1929,MYDLT,9483,5571,3912,2207,7276,E08000032,E99999999,E12000003,00CX,"Above 3,000 (b)",9,10
1930,MYDUD,10354,9897,457,4422,5932,E08000032,E99999999,E12000003,00CX,"Above 10,000 (b)",7,30
1931,MYDUN,1840,1624,216,1370,470,E07000167,E10000023,E12000003,36,"Above 1,000 (b)",11,10
1932,MYEAO,2951,2577,374,2361,590,E07000164,E10000023,E12000003,36,"Above 1,000 (a)",10,10
1933,MYEAT,546,422,124,343,203,E06000011,E99999999,E12000003,00FB,"Below 1,000 (b)",13,10
1934,MYELL,12142,7800,4342,4179,7963,E08000033,E99999999,E12000003,00CY,"Above 10,000 (a)",6,30
1935,MYELV,947,819,128,472,475,E06000011,E99999999,E12000003,00FB,"Below 1,000 (a)",12,10
1936,MYESC,798,477,321,384,414,E07000169,E10000023,E12000003,36,"Below 1,000 (b)",13,10
1937,MYFIL,4450,4188,262,3833,617,E07000168,E10000023,E12000003,36,"Above 3,000 (b)",9,10
1938,MYFLM,1879,1215,664,1066,813,E06000011,E99999999,E12000003,00FB,"Above 1,000 (b)",11,10
1939,MYFLO,3495,1282,2213,559,2936,E08000034,E99999999,E12000003,00CZ,"Above 3,000 (b)",9,10
1940,MYFLX,426,237,189,52,374,E07000167,E10000023,E12000003,36,"Below 1,000 (b)",13,10
1941,MYGAT,1760,347,1413,47,1713,E07000169,E10000023,E12000003,36,"Above 1,000 (b)",11,10
1942,MYGIL,2437,1744,693,1342,1095,E06000011,E99999999,E12000003,00FB,"Above 1,000 (b)",11,10
1943,MYGOO,10629,9586,1043,5265,5364,E06000011,E99999999,E12000003,00FB,"Above 10,000 (a)",6,30
1944,MYGRA,1366,1141,225,886,480,E07000163,E10000023,E12000003,36,"Above 1,000 (a)",10,10
1945,MYGRE,1146,772,374,294,852,E07000165,E10000023,E12000003,36,"Above 1,000 (b)",11,10
1946,MYGRF,14475,6988,7487,3887,10588,E08000035,E99999999,E12000003,00DA,Large City,2,50
1947,MYGRG,1157,964,193,855,302,E07000163,E10000023,E12000003,36,"Above 1,000 (b)",11,10
1948,MYGUI,10255,8090,2165,3344,6911,E08000032,E99999999,E12000003,00CX,"Above 10,000 (b)",7,30
1949,MYHAC,256,76,180,34,222,E07000167,E10000023,E12000003,36,"Below 1,000 (b)",13,10
1950,MYHAL,22373,18897,3476,4897,17476,E08000033,E99999999,E12000003,00CY,"Above 20,000 (a)",4,30
1951,MYHAW,8288,6447,1841,1878,6410,E08000032,E99999999,E12000003,00CX,"Above 3,000 (b)",9,10
1952,MYHAX,10772,7718,3054,1858,8914,E06000014,E99999999,E12000003,00FF,"Above 10,000 (b)",7,30
1953,MYHBK,17139,16994,145,8477,8662,E08000032,E99999999,E12000003,00CX,"Above 10,000 (a)",6,30
1954,MYHEA,24227,23503,724,9896,14331,E08000035,E99999999,E12000003,00DA,Large City,2,50
1955,MYHEB,4374,3695,679,2740,1634,E08000033,E99999999,E12000003,00CY,"Above 3,000 (a)",8,30
1956,MYHEC,14100,12954,1146,6069,8031,E08000034,E99999999,E12000003,00CZ,"Above 10,000 (a)",6,30
1957,MYHGT,18152,15528,2624,7430,10722,E07000165,E10000023,E12000003,36,"Above 10,000 (a)",6,30
1958,MYHHL,21446,20676,770,8431,13015,E08000035,E99999999,E12000003,00DA,Large City,2,50
1959,MYHIP,9334,6195,3139,2421,6913,E08000033,E99999999,E12000003,00CY,"Above 3,000 (b)",9,10
1960,MYHIR,358,169,189,130,228,E07000163,E10000023,E12000003,36,"Below 1,000 (b)",13,10
1961,MYHLI,749,704,45,673,76,E07000124,E10000017,E12000002,30,"Below 1,000 (b)",13,10
1962,MYHLM,1329,976,353,956,373,E07000167,E10000023,E12000003,36,"Above 1,000 (a)",10,10
1963,MYHLP,612,358,254,332,280,E07000165,E10000023,E12000003,36,"Below 1,000 (b)",13,10
1964,MYHLT,27856,19428,8428,6553,21303,E08000035,E99999999,E12000003,00DA,Large City,2,50
1965,MYHMB,1720,1233,487,737,983,E06000011,E99999999,E12000003,00FB,"Above 1,000 (b)",11,10
1966,MYHMF,8944,6309,2635,2211,6733,E08000034,E99999999,E12000003,00CZ,"Above 3,000 (b)",9,10
1967,MYHMW,10907,5316,5591,3855,7052,E08000036,E99999999,E12000003,00DB,"Above 10,000 (b)",7,30
1968,MYHNS,5000,4346,654,3113,1887,E06000011,E99999999,E12000003,00FB,"Above 3,000 (b)",9,10
1969,MYHOB,19973,13298,6675,5037,14936,E08000035,E99999999,E12000003,00DA,Large City,2,50
1970,MYHON,7956,5905,2051,1731,6225,E08000034,E99999999,E12000003,00CZ,"Above 3,000 (b)",9,10
1971,MYHOV,689,237,452,200,489,E07000167,E10000023,E12000003,36,"Below 1,000 (b)",13,10
1972,MYHOW,2537,2201,336,1921,616,E06000011,E99999999,E12000003,00FB,"Above 1,000 (b)",11,10
1973,MYHRW,548,295,253,195,353,E08000035,E99999999,E12000003,00DA,"Below 1,000 (b)",13,10
1974,MYHSF,18185,14930,3255,4771,13414,E08000035,E99999999,E12000003,00DA,Large City,2,50
1975,MYHSM,1700,1238,462,638,1062,E06000011,E99999999,E12000003,00FB,"Above 1,000 (b)",11,10
1976,MYHUB,726,550,176,357,369,E08000035,E99999999,E12000003,00DA,"Below 1,000 (b)",13,10
1977,MYHUD,35197,21785,13412,4927,30270,E08000034,E99999999,E12000003,00CZ,"Above 20,000 (a)",4,30
1978,MYHUG,406,103,303,95,311,E07000167,E10000023,E12000003,36,"Below 1,000 (b)",13,10
1979,MYHUM,2282,1787,495,1631,651,E06000011,E99999999,E12000003,00FB,"Above 1,000 (b)",11,10
1980,MYIDL,16459,14956,1503,6424,10035,E08000032,E99999999,E12000003,00CX,"Above 10,000 (a)",6,30
1981,MYILK,7310,7195,115,4373,2937,E08000032,E99999999,E12000003,00CX,"Above 3,000 (b)",9,10
1982,MYILL,12751,10406,2345,3785,8966,E08000033,E99999999,E12000003,00CY,"Above 10,000 (a)",6,30
1983,MYKEI,19876,16849,3027,6964,12912,E08000032,E99999999,E12000003,00CX,"Above 10,000 (a)",6,30
1984,MYKET,384,211,173,146,238,E07000163,E10000023,E12000003,36,"Below 1,000 (b)",13,10
1985,MYKEY,13007,2028,10979,594,12413,E06000011,E99999999,E12000003,00FB,"Above 10,000 (b)",7,30
1986,MYKIL,644,467,177,330,314,E06000011,E99999999,E12000003,00FB,"Below 1,000 (b)",13,10
1987,MYKKB,7768,3284,4484,1792,5976,E08000034,E99999999,E12000003,00CZ,"Above 3,000 (b)",9,10
1988,MYKMP,679,216,463,98,581,E07000167,E10000023,E12000003,36,"Below 1,000 (b)",13,10
1989,MYKMS,2492,1696,796,1503,989,E07000167,E10000023,E12000003,36,"Above 1,000 (a)",10,10
1990,MYKMZ,885,582,303,405,480,E07000165,E10000023,E12000003,36,"Below 1,000 (b)",13,10
1991,MYKNA,7840,7027,813,5034,2806,E07000165,E10000023,E12000003,36,"Above 3,000 (b)",9,10
1992,MYKNO,8539,7223,1316,2943,5596,E07000169,E10000023,E12000003,36,"Above 3,000 (b)",9,10
1993,MYLAI,11994,11988,6,6902,5092,E08000032,E99999999,E12000003,00CX,"Above 10,000 (a)",6,30
1994,MYLAN,273,211,62,181,92,E07000167,E10000023,E12000003,36,"Below 1,000 (b)",13,10
1995,MYLAS,708,139,569,1,707,E07000167,E10000023,E12000003,36,"Below 1,000 (b)",13,10
1996,MYLEC,20800,819,19981,695,20105,E06000011,E99999999,E12000003,00FB,"Above 20,000 (b)",5,30
1997,MYLEV,2457,1211,1246,1056,1401,E06000011,E99999999,E12000003,00FB,"Above 1,000 (b)",11,10
1998,MYLIN,1097,485,612,355,742,E07000165,E10000023,E12000003,36,"Above 1,000 (b)",11,10
1999,MYLOC,350,147,203,91,259,E07000167,E10000023,E12000003,36,"Below 1,000 (b)",13,10
2000,MYLOF,15147,9387,5760,3381,11766,E08000035,E99999999,E12000003,00DA,Large City,2,50
2001,MYLON,625,361,264,307,318,E07000124,E10000017,E12000002,30,"Below 1,000 (b)",13,10
2002,MYLOW,17518,14251,3267,3614,13904,E08000033,E99999999,E12000003,00CY,"Above 10,000 (b)",7,30
2003,MYLS,14414,14374,40,6371,8043,E08000035,E99999999,E12000003,00DA,Large City,2,50
2004,MYMAL,7326,6615,711,3375,3951,E07000167,E10000023,E12000003,36,"Above 3,000 (b)",9,10
2005,MYMAN,17737,15185,2552,8598,9139,E08000032,E99999999,E12000003,00CX,"Above 10,000 (a)",6,30
2006,MYMAR,3743,3337,406,3020,723,E06000011,E99999999,E12000003,00FB,"Above 3,000 (b)",9,10
2007,MYMAS,924,761,163,693,231,E07000165,E10000023,E12000003,36,"Below 1,000 (b)",13,10
2008,MYMID,624,385,239,307,317,E06000011,E99999999,E12000003,00FB,"Below 1,000 (b)",13,10
2009,MYMIL,25430,19715,5715,5336,20094,E08000033,E99999999,E12000003,00CY,"Above 20,000 (b)",5,30
2010,MYMIR,13756,9935,3821,3534,10222,E08000033,E99999999,E12000003,00CY,"Above 10,000 (b)",7,30
2011,MYMLB,697,347,350,248,449,E06000011,E99999999,E12000003,00FB,"Below 1,000 (b)",13,10
2012,MYMMB,591,353,238,170,421,E07000165,E10000023,E12000003,36,"Below 1,000 (b)",13,10
2013,MYMOO,23758,19283,4475,7154,16604,E08000035,E99999999,E12000003,00DA,Large City,2,50
2014,MYMOR,21918,14508,7410,8175,13743,E08000035,E99999999,E12000003,00DA,Large City,2,50
2015,MYMSG,14450,12594,1856,5599,8851,E06000014,E99999999,E12000003,00FF,"Above 10,000 (a)",6,30
2016,MYMTH,4061,3856,205,3502,559,E08000034,E99999999,E12000003,00CZ,"Above 3,000 (b)",9,10
2017,MYNCV,8797,1951,6846,852,7945,E06000013,E99999999,E12000003,00FD,"Above 3,000 (b)",9,10
2018,MYNGR,307,39,268,28,279,E07000167,E10000023,E12000003,36,"Below 1,000 (a)",12,10
2019,MYNMN,11551,10364,1187,4886,6665,E08000035,E99999999,E12000003,00DA,Large City,2,50
2020,MYNND,989,489,500,364,625,E06000011,E99999999,E12000003,00FB,"Below 1,000 (b)",13,10
2021,MYNSY,534,261,273,232,302,E07000165,E10000023,E12000003,36,"Below 1,000 (a)",12,10
2022,MYNUN,315,117,198,74,241,E07000167,E10000023,E12000003,36,"Below 1,000 (b)",13,10
2023,MYOAT,6983,6017,966,4117,2866,E07000165,E10000023,E12000003,36,"Above 3,000 (b)",9,10
2024,MYOTL,7344,6957,387,4046,3298,E08000035,E99999999,E12000003,00DA,"Above 3,000 (b)",9,10
2025,MYPBG,1589,1253,336,874,715,E07000165,E10000023,E12000003,36,"Above 1,000 (b)",11,10
2026,MYPIC,5145,3897,1248,3025,2120,E07000167,E10000023,E12000003,36,"Above 3,000 (a)",8,30
2027,MYPOC,5176,4273,903,3726,1450,E06000011,E99999999,E12000003,00FB,"Above 3,000 (b)",9,10
2028,MYPON,21510,12754,8756,5110,16400,E08000036,E99999999,E12000003,00DB,"Above 20,000 (b)",5,30
2029,MYPTN,1405,893,512,668,737,E06000011,E99999999,E12000003,00FB,"Above 1,000 (b)",11,10
2030,MYPUD,26435,21776,4659,6239,20196,E08000035,E99999999,E12000003,00DA,Large City,2,50
2031,MYQUE,15799,11006,4793,3511,12288,E08000033,E99999999,E12000003,00CY,"Above 10,000 (b)",7,30
2032,MYRAM,247,119,128,38,209,E07000165,E10000023,E12000003,36,"Below 1,000 (b)",13,10
2033,MYREE,595,199,396,117,478,E06000011,E99999999,E12000003,00FB,"Below 1,000 (b)",13,10
2034,MYRIC,1553,1151,402,1032,521,E07000169,E10000023,E12000003,36,"Above 1,000 (a)",10,10
2035,MYRIL,950,572,378,500,450,E07000167,E10000023,E12000003,36,"Below 1,000 (b)",13,10
2036,MYROT,12140,8667,3473,3694,8446,E08000035,E99999999,E12000003,00DA,Large City,2,50
2037,MYRPN,8695,8101,594,4141,4554,E07000165,E10000023,E12000003,36,"Above 3,000 (a)",8,30
2038,MYRPP,4119,2488,1631,987,3132,E08000033,E99999999,E12000003,00CY,"Above 3,000 (b)",9,10
2039,MYRUF,983,371,612,259,724,E07000165,E10000023,E12000003,36,"Below 1,000 (b)",13,10
2040,MYRWC,1260,888,372,599,661,E06000011,E99999999,E12000003,00FB,"Above 1,000 (a)",10,10
2041,MYRWD,9436,6654,2782,2185,7251,E08000032,E99999999,E12000003,00CX,"Above 3,000 (b)",9,10
2042,MYSAN,11898,7573,4325,2402,9496,E08000036,E99999999,E12000003,00DB,"Above 10,000 (a)",6,30
2043,MYSAW,443,144,299,88,355,E07000165,E10000023,E12000003,36,"Below 1,000 (b)",13,10
2044,MYSBG,2144,1621,523,1397,747,E07000167,E10000023,E12000003,36,"Above 1,000 (b)",11,10
2045,MYSBN,739,420,319,82,657,E07000167,E10000023,E12000003,36,"Below 1,000 (b)",13,10
2046,MYSCA,22982,19959,3023,10686,12296,E07000168,E10000023,E12000003,36,"Above 20,000 (a)",4,30
2047,MYSEA,12756,11340,1416,5777,6979,E08000035,E99999999,E12000003,00DA,Large City,2,50
2048,MYSEL,11996,9899,2097,5257,6739,E07000169,E10000023,E12000003,36,"Above 10,000 (a)",6,30
2049,MYSEM,11808,6850,4958,4197,7611,E08000017,E99999999,E12000003,00CE,"Above 10,000 (b)",7,30
2050,MYSET,2646,2363,283,2123,523,E07000163,E10000023,E12000003,36,"Above 1,000 (a)",10,10
2051,MYSHF,731,537,194,411,320,E07000164,E10000023,E12000003,36,"Below 1,000 (b)",13,10
2052,MYSHI,19341,15217,4124,5713,13628,E08000032,E99999999,E12000003,00CX,"Above 10,000 (b)",7,30
2053,MYSKE,6266,3837,2429,1109,5157,E08000034,E99999999,E12000003,00CZ,"Above 3,000 (b)",9,10
2054,MYSKP,9710,7940,1770,5683,4027,E07000163,E10000023,E12000003,36,"Above 3,000 (b)",9,10
2055,MYSKR,68378,723,67655,652,67726,E06000011,E99999999,E12000003,00FB,"Above 20,000 (b)",5,30
2056,MYSKS,676,392,284,302,374,E06000011,E99999999,E12000003,00FB,"Below 1,000 (b)",13,10
2057,MYSLA,6589,3233,3356,1852,4737,E08000033,E99999999,E12000003,00CY,"Above 3,000 (b)",9,10
2058,MYSML,4914,2704,2210,1099,3815,E08000035,E99999999,E12000003,00DA,"Above 3,000 (b)",9,10
2059,MYSNH,2118,1718,400,1318,800,E06000011,E99999999,E12000003,00FB,"Above 1,000 (a)",10,10
2060,MYSNN,1087,503,584,348,739,E07000167,E10000023,E12000003,36,"Above 1,000 (b)",11,10
2061,MYSOW,10124,8293,1831,3696,6428,E08000033,E99999999,E12000003,00CY,"Above 10,000 (b)",7,30
2062,MYSPO,1098,522,576,456,642,E07000165,E10000023,E12000003,36,"Above 1,000 (a)",10,10
2063,MYSPU,488,274,214,241,247,E06000011,E99999999,E12000003,00FB,"Below 1,000 (a)",12,10
2064,MYSRB,12633,11702,931,5796,6837,E07000165,E10000023,E12000003,36,"Above 10,000 (a)",6,30
2065,MYSTE,5621,5293,328,3386,2235,E07000163,E10000023,E12000003,36,"Above 3,000 (b)",9,10
2066,MYSTI,1238,543,695,353,885,E07000164,E10000023,E12000003,36,"Above 1,000 (a)",10,10
2067,MYSTO,749,567,182,353,396,E07000167,E10000023,E12000003,36,"Below 1,000 (b)",13,10
2068,MYSTR,2979,2494,485,1988,991,E07000164,E10000023,E12000003,36,"Above 1,000 (b)",11,10
2069,MYSYK,802,224,578,105,697,E08000017,E99999999,E12000003,00CE,"Below 1,000 (b)",13,10
2070,MYTAD,3665,3319,346,2111,1554,E08000035,E99999999,E12000003,00DA,"Above 3,000 (b)",9,10
2071,MYTHN,8315,5891,2424,3289,5026,E08000017,E99999999,E12000003,00CE,"Above 3,000 (b)",9,10
2072,MYTHR,1568,1111,457,685,883,E08000035,E99999999,E12000003,00DA,"Above 1,000 (b)",11,10
2073,MYTHT,6750,3418,3332,2308,4442,E08000033,E99999999,E12000003,00CY,"Above 3,000 (b)",9,10
2074,MYTHW,577,151,426,138,439,E07000167,E10000023,E12000003,36,"Below 1,000 (b)",13,10
2075,MYTIB,282,118,164,66,216,E06000011,E99999999,E12000003,00FB,"Below 1,000 (b)",13,10
2076,MYTOC,1131,578,553,49,1082,E07000165,E10000023,E12000003,36,"Above 1,000 (b)",11,10
2077,MYTOL,813,459,354,358,455,E07000164,E10000023,E12000003,36,"Below 1,000 (b)",13,10
2078,MYUND,14084,14003,81,7449,6635,E08000032,E99999999,E12000003,00CX,"Above 10,000 (a)",6,30
2079,MYWAK,22208,17425,4783,5238,16970,E08000036,E99999999,E12000003,00DB,"Above 20,000 (a)",4,30
2080,MYWAT,1255,327,928,76,1179,E06000011,E99999999,E12000003,00FB,"Above 1,000 (b)",11,10
2081,MYWAY,2067,1275,792,825,1242,E07000168,E10000023,E12000003,36,"Above 1,000 (b)",11,10
2082,MYWBG,2498,1422,1076,905,1593,E07000169,E10000023,E12000003,36,"Above 1,000 (b)",11,10
2083,MYWEH,5917,5581,336,3335,2582,E08000035,E99999999,E12000003,00DA,"Above 3,000 (b)",9,10
2084,MYWEN,1377,339,1038,251,1126,E08000017,E99999999,E12000003,00CE,"Above 1,000 (b)",11,10
2085,MYWEW,514,347,167,343,171,E06000011,E99999999,E12000003,00FB,"Below 1,000 (b)",13,10
2086,MYWHE,1119,853,266,774,345,E06000011,E99999999,E12000003,00FB,"Above 1,000 (b)",11,10
2087,MYWHL,262,129,133,94,168,E07000167,E10000023,E12000003,36,"Below 1,000 (a)",12,10
2088,MYWIL,1187,908,279,714,473,E06000011,E99999999,E12000003,00FB,"Above 1,000 (b)",11,10
2089,MYWIT,3630,3287,343,2767,863,E06000011,E99999999,E12000003,00FB,"Above 3,000 (b)",9,10
2090,MYWLT,485,189,296,51,434,E07000167,E10000023,E12000003,36,"Below 1,000 (b)",13,10
2091,MYWOH,853,174,679,60,793,E07000167,E10000023,E12000003,36,"Below 1,000 (b)",13,10
2092,MYYO,17498,17385,113,8979,8519,E06000014,E99999999,E12000003,00FF,"Above 10,000 (a)",6,30
2093,NDACO,7473,6602,871,2165,5308,E07000108,E10000016,E12000008,29,"Above 3,000 (b)",9,10
2094,NDAGR,3078,2684,394,367,2711,E07000111,E10000016,E12000008,29,"Above 3,000 (b)",9,10
2095,NDALD,1097,566,531,367,730,E07000112,E10000016,E12000008,29,"Above 1,000 (b)",11,10
2096,NDALL,1465,814,651,386,1079,E06000035,E99999999,E12000008,00LC,"Above 1,000 (b)",11,10
2097,NDAPP,572,381,191,193,379,E07000112,E10000016,E12000008,29,"Below 1,000 (b)",13,10
2098,NDASF,24847,14106,10741,4086,20761,E07000105,E10000016,E12000008,29,"Above 20,000 (a)",4,30
2099,NDASH,1970,1251,719,1008,962,E07000108,E10000016,E12000008,29,"Above 1,000 (b)",11,10
2100,NDAYL,6962,4757,2205,1222,5740,E07000115,E10000016,E12000008,29,"Above 3,000 (b)",9,10
2101,NDBAL,4389,3157,1232,1498,2891,E07000064,E10000011,E12000008,21,"Above 3,000 (b)",9,10
2102,NDBAR,8542,7950,592,4379,4163,E07000115,E10000016,E12000008,29,"Above 3,000 (b)",9,10
2103,NDBAT,3004,2666,338,1514,1490,E07000064,E10000011,E12000008,21,"Above 3,000 (b)",9,10
2104,NDBEA,6502,5636,866,1673,4829,E07000110,E10000016,E12000008,29,"Above 3,000 (b)",9,10
2105,NDBEC,490,412,78,274,216,E07000064,E10000011,E12000008,21,"Below 1,000 (a)",12,10
2106,NDBEN,1255,602,653,340,915,E07000105,E10000016,E12000008,29,"Above 1,000 (b)",11,10
2107,NDBET,848,660,188,435,413,E07000105,E10000016,E12000008,29,"Below 1,000 (b)",13,10
2108,NDBEX,17653,15282,2371,7766,9887,E07000064,E10000011,E12000008,21,"Above 10,000 (a)",6,30
2109,NDBGR,4031,2831,1200,1883,2148,E07000111,E10000016,E12000008,29,"Above 3,000 (b)",9,10
2110,NDBHI,6355,5130,1225,3350,3005,E09000006,E99999999,E12000007,00London,"Above 3,000 (b)",9,10
2111,NDBID,1180,870,310,618,562,E07000105,E10000016,E12000008,29,"Above 1,000 (b)",11,10
2112,NDBIR,6173,5713,460,4110,2063,E07000114,E10000016,E12000008,29,"Above 3,000 (b)",9,10
2113,NDBLH,15394,6154,9240,890,14504,E06000035,E99999999,E12000008,00LC,Small City,3,50
2114,NDBOU,2375,1422,953,1049,1326,E07000106,E10000016,E12000008,29,"Above 1,000 (b)",11,10
2115,NDBRD,1052,773,279,476,576,E07000064,E10000011,E12000008,21,"Above 1,000 (b)",11,10
2116,NDBRE,1876,976,900,347,1529,E07000116,E10000016,E12000008,29,"Above 1,000 (b)",11,10
2117,NDBRG,472,134,338,44,428,E07000064,E10000011,E12000008,21,"Below 1,000 (b)",13,10
2118,NDBRI,1586,967,619,620,966,E07000106,E10000016,E12000008,29,"Above 1,000 (b)",11,10
2119,NDBRK,569,332,237,172,397,E07000112,E10000016,E12000008,29,"Below 1,000 (b)",13,10
2120,NDBRO,14273,12443,1830,5868,8405,E07000114,E10000016,E12000008,29,"Above 10,000 (a)",6,30
2121,NDBUR,1038,755,283,564,474,E07000064,E10000011,E12000008,21,"Above 1,000 (b)",11,10
2122,NDBUX,1428,953,475,752,676,E07000065,E10000011,E12000008,21,"Above 1,000 (b)",11,10
2123,NDCAN,22705,19238,3467,8520,14185,E07000106,E10000016,E12000008,29,"Above 20,000 (a)",4,30
2124,NDCAS,10822,9000,1822,3703,7119,E07000064,E10000011,E12000008,21,"Above 10,000 (b)",7,30
2125,NDCDO,3421,3389,32,1948,1473,E06000035,E99999999,E12000008,00LC,"Above 3,000 (a)",8,30
2126,NDCGA,532,448,84,244,288,E07000228,E10000032,E12000008,45,"Below 1,000 (b)",13,10
2127,NDCHA,1752,1133,619,793,959,E07000113,E10000016,E12000008,29,"Above 1,000 (b)",11,10
2128,NDCHD,1273,766,507,159,1114,E07000065,E10000011,E12000008,21,"Above 1,000 (b)",11,10
2129,NDCHE,9451,8954,497,6063,3388,E07000112,E10000016,E12000008,29,"Above 3,000 (b)",9,10
2130,NDCHI,1630,432,1198,79,1551,E07000106,E10000016,E12000008,29,"Above 1,000 (b)",11,10
2131,NDCHL,867,397,470,170,697,E07000113,E10000016,E12000008,29,"Below 1,000 (b)",13,10
2132,NDCHR,2298,1088,1210,204,2094,E07000106,E10000016,E12000008,29,"Above 1,000 (b)",11,10
2133,NDCHS,4802,3624,1178,966,3836,E07000106,E10000016,E12000008,29,"Above 3,000 (b)",9,10
2134,NDCLI,2390,1206,1184,881,1509,E06000034,E99999999,E12000006,00KG,"Above 1,000 (b)",11,10
2135,NDCOO,5260,4884,376,2985,2275,E07000065,E10000011,E12000008,21,"Above 3,000 (b)",9,10
2136,NDCOP,5253,2891,2362,347,4906,E07000228,E10000032,E12000008,45,"Above 3,000 (b)",9,10
2137,NDCOW,854,423,431,73,781,E07000065,E10000011,E12000008,21,"Below 1,000 (b)",13,10
2138,NDCRA,2834,2196,638,1795,1039,E07000116,E10000016,E12000008,29,"Above 1,000 (b)",11,10
2139,NDCRO,9357,7456,1901,2813,6544,E07000065,E10000011,E12000008,21,"Above 3,000 (b)",9,10
2140,NDCRW,772,347,425,158,614,E07000064,E10000011,E12000008,21,"Below 1,000 (b)",13,10
2141,NDCST,487,304,183,144,343,E07000110,E10000016,E12000008,29,"Below 1,000 (b)",13,10
2142,NDDEA,16660,12483,4177,5755,10905,E07000108,E10000016,E12000008,29,"Above 10,000 (a)",6,30
2143,NDDHI,929,667,262,251,678,E07000228,E10000032,E12000008,45,"Below 1,000 (b)",13,10
2144,NDDOD,408,295,113,189,219,E07000113,E10000016,E12000008,29,"Below 1,000 (b)",13,10
2145,NDDOV,12768,12238,530,6415,6353,E07000108,E10000016,E12000008,29,"Above 10,000 (a)",6,30
2146,NDDPA,1767,1422,345,373,1394,E07000228,E10000032,E12000008,45,"Above 1,000 (b)",11,10
2147,NDDYM,3228,1770,1458,886,2342,E07000112,E10000016,E12000008,29,"Above 3,000 (b)",9,10
2148,NDEAS,596,290,306,137,459,E07000113,E10000016,E12000008,29,"Below 1,000 (b)",13,10
2149,NDECH,856,848,8,429,427,E07000113,E10000016,E12000008,29,"Below 1,000 (b)",13,10
2150,NDEDE,4400,4096,304,2907,1493,E07000215,E10000030,E12000008,43,"Above 3,000 (b)",9,10
2151,NDEGE,686,405,281,144,542,E07000105,E10000016,E12000008,29,"Below 1,000 (b)",13,10
2152,NDEGR,12630,11377,1253,5921,6709,E07000228,E10000032,E12000008,45,"Above 10,000 (b)",7,30
2153,NDELH,606,515,91,430,176,E07000106,E10000016,E12000008,29,"Below 1,000 (b)",13,10
2154,NDELM,443,169,274,50,393,E07000106,E10000016,E12000008,29,"Below 1,000 (b)",13,10
2155,NDEPE,1767,1504,263,1136,631,E07000115,E10000016,E12000008,29,"Above 1,000 (b)",11,10
2156,NDETC,374,333,41,216,158,E07000064,E10000011,E12000008,21,"Below 1,000 (a)",12,10
2157,NDFAI,2501,1962,539,384,2117,E07000111,E10000016,E12000008,29,"Above 1,000 (b)",11,10
2158,NDFAV,9912,9345,567,6506,3406,E07000113,E10000016,E12000008,29,"Above 3,000 (b)",9,10
2159,NDFEL,738,341,397,221,517,E07000111,E10000016,E12000008,29,"Below 1,000 (b)",13,10
2160,NDFLI,513,440,73,302,211,E07000064,E10000011,E12000008,21,"Below 1,000 (b)",13,10
2161,NDFOL,15090,14124,966,7669,7421,E07000108,E10000016,E12000008,29,"Above 10,000 (b)",7,30
2162,NDFOR,625,374,251,203,422,E07000065,E10000011,E12000008,21,"Below 1,000 (b)",13,10
2163,NDFRA,1151,487,664,288,863,E07000065,E10000011,E12000008,21,"Above 1,000 (b)",11,10
2164,NDFRI,449,278,171,37,412,E07000105,E10000016,E12000008,29,"Below 1,000 (b)",13,10
2165,NDFRM,959,696,263,325,634,E07000065,E10000011,E12000008,21,"Below 1,000 (b)",13,10
2166,NDFRO,2985,2612,373,1518,1467,E07000228,E10000032,E12000008,45,"Above 1,000 (b)",11,10
2167,NDGIL,20310,18348,1962,9273,11037,E06000035,E99999999,E12000008,00LC,Small City,3,50
2168,NDGOD,2135,1833,302,1077,1058,E07000215,E10000030,E12000008,43,"Above 1,000 (b)",11,10
2169,NDGOU,1275,807,468,487,788,E07000110,E10000016,E12000008,29,"Above 1,000 (b)",11,10
2170,NDGRA,27756,18766,8990,6914,20842,E06000034,E99999999,E12000006,00KG,"Above 20,000 (a)",4,30
2171,NDGUE,3480,861,2619,270,3210,E07000064,E10000011,E12000008,21,"Above 3,000 (b)",9,10
2172,NDHAD,2120,1541,579,1218,902,E07000115,E10000016,E12000008,29,"Above 1,000 (b)",11,10
2173,NDHAK,2177,2038,139,1377,800,E07000064,E10000011,E12000008,21,"Above 1,000 (b)",11,10
2174,NDHAL,896,341,555,159,737,E07000063,E10000011,E12000008,21,"Below 1,000 (b)",13,10
2175,NDHAR,982,583,399,294,688,E07000065,E10000011,E12000008,21,"Below 1,000 (b)",13,10
2176,NDHAS,24114,17233,6881,5270,18844,E07000062,E10000011,E12000008,21,"Above 20,000 (a)",4,30
2177,NDHAW,4168,3681,487,2665,1503,E07000108,E10000016,E12000008,29,"Above 3,000 (b)",9,10
2178,NDHBA,16901,12246,4655,5583,11318,E07000106,E10000016,E12000008,29,"Above 10,000 (b)",7,30
2179,NDHDO,798,336,462,187,611,E07000065,E10000011,E12000008,21,"Below 1,000 (b)",13,10
2180,NDHEA,4842,3929,913,2838,2004,E07000065,E10000011,E12000008,21,"Above 3,000 (b)",9,10
2181,NDHED,1729,1578,151,1325,404,E07000105,E10000016,E12000008,29,"Above 1,000 (b)",11,10
2182,NDHGR,723,674,49,536,187,E07000064,E10000011,E12000008,21,"Below 1,000 (a)",12,10
2183,NDHHA,722,605,117,432,290,E07000105,E10000016,E12000008,29,"Below 1,000 (a)",12,10
2184,NDHIL,4524,2035,2489,1144,3380,E07000111,E10000016,E12000008,29,"Above 3,000 (b)",9,10
2185,NDHOL,777,476,301,277,500,E07000110,E10000016,E12000008,29,"Below 1,000 (b)",13,10
2186,NDHOO,5027,3735,1292,2992,2035,E07000113,E10000016,E12000008,29,"Above 3,000 (b)",9,10
2187,NDHRO,1645,1239,406,833,812,E07000065,E10000011,E12000008,21,"Above 1,000 (b)",11,10
2188,NDHST,2126,332,1794,116,2010,E07000112,E10000016,E12000008,29,"Above 1,000 (b)",11,10
2189,NDHUN,1530,494,1036,123,1407,E07000110,E10000016,E12000008,29,"Above 1,000 (b)",11,10
2190,NDHYT,7632,6206,1426,3803,3829,E07000112,E10000016,E12000008,29,"Above 3,000 (b)",9,10
2191,NDIDE,374,350,24,207,167,E07000064,E10000011,E12000008,21,"Below 1,000 (a)",12,10
2192,NDIHI,1154,444,710,172,982,E07000111,E10000016,E12000008,29,"Above 1,000 (b)",11,10
2193,NDISF,366,295,71,213,153,E07000063,E10000011,E12000008,21,"Below 1,000 (b)",13,10
2194,NDKNO,2161,913,1248,372,1789,E09000006,E99999999,E12000007,00London,"Above 1,000 (b)",11,10
2195,NDLAM,940,592,348,458,482,E07000065,E10000011,E12000008,21,"Below 1,000 (b)",13,10
2196,NDLAN,3994,3079,915,1038,2956,E07000065,E10000011,E12000008,21,"Above 3,000 (b)",9,10
2197,NDLEN,2642,1562,1080,1025,1617,E07000110,E10000016,E12000008,29,"Above 1,000 (b)",11,10
2198,NDLEY,1588,1549,39,508,1080,E07000113,E10000016,E12000008,29,"Above 1,000 (a)",10,10
2199,NDLIN,2532,2015,517,1349,1183,E07000215,E10000030,E12000008,43,"Above 1,000 (b)",11,10
2200,NDLON,4757,3602,1155,1331,3426,E07000111,E10000016,E12000008,29,"Above 3,000 (b)",9,10
2201,NDLOO,11770,8540,3230,2163,9607,E07000110,E10000016,E12000008,29,"Above 10,000 (a)",6,30
2202,NDLYD,2650,1669,981,1232,1418,E07000064,E10000011,E12000008,21,"Above 1,000 (b)",11,10
2203,NDLYM,1495,1225,270,888,607,E07000112,E10000016,E12000008,29,"Above 1,000 (b)",11,10
2204,NDMAI,21605,20355,1250,8707,12898,E07000110,E10000016,E12000008,29,"Above 20,000 (a)",4,30
2205,NDMAR,1764,1506,258,1111,653,E07000110,E10000016,E12000008,29,"Above 1,000 (b)",11,10
2206,NDMAY,1488,1196,292,836,652,E07000065,E10000011,E12000008,21,"Above 1,000 (a)",10,10
2207,NDMED,26995,19272,7723,8008,18987,E06000035,E99999999,E12000008,00LC,Small City,3,50
2208,NDMEO,2833,2152,681,1168,1665,E07000111,E10000016,E12000008,29,"Above 1,000 (b)",11,10
2209,NDMIL,440,282,158,67,373,E07000113,E10000016,E12000008,29,"Below 1,000 (b)",13,10
2210,NDMSH,7537,7233,304,3597,3940,E07000113,E10000016,E12000008,29,"Above 3,000 (b)",9,10
2211,NDMTH,2617,1593,1024,1092,1525,E07000114,E10000016,E12000008,29,"Above 1,000 (a)",10,10
2212,NDNEI,1862,1264,598,957,905,E07000063,E10000011,E12000008,21,"Above 1,000 (b)",11,10
2213,NDNEW,2964,1693,1271,1029,1935,E07000113,E10000016,E12000008,29,"Above 1,000 (b)",11,10
2214,NDNIN,1316,710,606,499,817,E07000065,E10000011,E12000008,21,"Above 1,000 (b)",11,10
2215,NDNON,3443,1744,1699,199,3244,E07000106,E10000016,E12000008,29,"Above 3,000 (b)",9,10
2216,NDNOR,1215,973,242,746,469,E07000064,E10000011,E12000008,21,"Above 1,000 (b)",11,10
2217,NDNRO,4133,3174,959,1958,2175,E07000112,E10000016,E12000008,29,"Above 3,000 (b)",9,10
2218,NDNUT,1372,778,594,217,1155,E07000065,E10000011,E12000008,21,"Above 1,000 (b)",11,10
2219,NDOTF,2583,1837,746,531,2052,E07000111,E10000016,E12000008,29,"Above 1,000 (b)",11,10
2220,NDOTH,4591,3498,1093,203,4388,E07000110,E10000016,E12000008,29,"Above 3,000 (b)",9,10
2221,NDOXT,6085,3826,2259,2289,3796,E07000215,E10000030,E12000008,43,"Above 3,000 (b)",9,10
2222,NDPEA,623,588,35,427,196,E07000064,E10000011,E12000008,21,"Below 1,000 (b)",13,10
2223,NDPEM,3149,2592,557,1846,1303,E07000065,E10000011,E12000008,21,"Above 3,000 (b)",9,10
2224,NDPEN,988,450,538,234,754,E07000111,E10000016,E12000008,29,"Below 1,000 (b)",13,10
2225,NDPET,1090,302,788,156,934,E07000106,E10000016,E12000008,29,"Above 1,000 (b)",11,10
2226,NDPLA,927,597,330,353,574,E07000111,E10000016,E12000008,29,"Below 1,000 (b)",13,10
2227,NDPLU,691,496,195,281,410,E07000105,E10000016,E12000008,29,"Below 1,000 (b)",13,10
2228,NDPWO,4394,3806,588,3341,1053,E07000110,E10000016,E12000008,29,"Above 3,000 (b)",9,10
2229,NDRAI,24324,14624,9700,6382,17942,E07000113,E10000016,E12000008,29,"Above 20,000 (a)",4,30
2230,NDRAM,18320,15938,2382,9435,8885,E07000114,E10000016,E12000008,29,"Above 10,000 (a)",6,30
2231,NDRGR,1065,515,550,128,937,E07000065,E10000011,E12000008,21,"Above 1,000 (b)",11,10
2232,NDROB,1287,1115,172,774,513,E07000064,E10000011,E12000008,21,"Above 1,000 (a)",10,10
2233,NDROT,1767,995,772,689,1078,E07000065,E10000011,E12000008,21,"Above 1,000 (b)",11,10
2234,NDRYE,4937,3045,1892,2461,2476,E07000064,E10000011,E12000008,21,"Above 3,000 (b)",9,10
2235,NDSAH,896,620,276,368,528,E07000064,E10000011,E12000008,21,"Below 1,000 (b)",13,10
2236,NDSAN,4943,3363,1580,1958,2985,E07000108,E10000016,E12000008,29,"Above 3,000 (b)",9,10
2237,NDSEA,4626,4293,333,886,3740,E07000111,E10000016,E12000008,29,"Above 3,000 (b)",9,10
2238,NDSED,855,698,157,496,359,E07000064,E10000011,E12000008,21,"Below 1,000 (b)",13,10
2239,NDSEI,9659,6930,2729,3503,6156,E07000105,E10000016,E12000008,29,"Above 3,000 (b)",9,10
2240,NDSEL,2497,746,1751,516,1981,E07000112,E10000016,E12000008,29,"Above 1,000 (b)",11,10
2241,NDSES,610,150,460,40,570,E07000106,E10000016,E12000008,29,"Below 1,000 (b)",13,10
2242,NDSEV,10652,7124,3528,2762,7890,E07000111,E10000016,E12000008,29,"Above 10,000 (a)",6,30
2243,NDSGO,1583,982,601,631,952,E07000215,E10000030,E12000008,43,"Above 1,000 (b)",11,10
2244,NDSHA,982,733,249,462,520,E07000228,E10000032,E12000008,45,"Below 1,000 (b)",13,10
2245,NDSHE,9438,6250,3188,4886,4552,E07000113,E10000016,E12000008,29,"Above 3,000 (b)",9,10
2246,NDSHO,4704,1773,2931,424,4280,E07000109,E10000016,E12000008,29,"Above 3,000 (b)",9,10
2247,NDSHP,1970,791,1179,656,1314,E07000106,E10000016,E12000008,29,"Above 1,000 (b)",11,10
2248,NDSIT,23955,18076,5879,5632,18323,E07000113,E10000016,E12000008,29,"Above 20,000 (a)",4,30
2249,NDSMA,567,476,91,321,246,E07000105,E10000016,E12000008,29,"Below 1,000 (b)",13,10
2250,NDSMB,2068,1285,783,1022,1046,E07000108,E10000016,E12000008,29,"Above 1,000 (b)",11,10
2251,NDSMI,485,273,212,149,336,E07000106,E10000016,E12000008,29,"Below 1,000 (b)",13,10
2252,NDSML,2449,1878,571,1434,1015,E07000215,E10000030,E12000008,43,"Above 1,000 (b)",11,10
2253,NDSNO,7957,5533,2424,4177,3780,E06000035,E99999999,E12000008,00LC,Small City,3,50
2254,NDSOU,6633,4224,2409,344,6289,E07000107,E10000016,E12000008,29,"Above 3,000 (b)",9,10
2255,NDSTA,2732,2467,265,2108,624,E07000110,E10000016,E12000008,29,"Above 1,000 (a)",10,10
2256,NDSTP,649,392,257,94,555,E07000064,E10000011,E12000008,21,"Below 1,000 (b)",13,10
2257,NDSTR,20144,14463,5681,5558,14586,E07000109,E10000016,E12000008,29,"Above 20,000 (b)",5,30
2258,NDSTU,4030,3414,616,2029,2001,E07000106,E10000016,E12000008,29,"Above 3,000 (b)",9,10
2259,NDSVA,1996,959,1037,505,1491,E07000110,E10000016,E12000008,29,"Above 1,000 (b)",11,10
2260,NDTEN,4133,3652,481,2377,1756,E07000105,E10000016,E12000008,29,"Above 3,000 (b)",9,10
2261,NDTEY,2286,1723,563,1381,905,E07000113,E10000016,E12000008,29,"Above 1,000 (b)",11,10
2262,NDTHA,17704,14712,2992,8312,9392,E07000114,E10000016,E12000008,29,"Above 10,000 (b)",7,30
2263,NDTIC,1238,1013,225,817,421,E07000064,E10000011,E12000008,21,"Above 1,000 (b)",11,10
2264,NDTON,14536,10426,4110,6002,8534,E07000111,E10000016,E12000008,29,"Above 10,000 (a)",6,30
2265,NDTWE,27622,20983,6639,9121,18501,E07000116,E10000016,E12000008,29,"Above 20,000 (a)",4,30
2266,NDUCK,7379,6805,574,4579,2800,E07000065,E10000011,E12000008,21,"Above 3,000 (a)",8,30
2267,NDWAD,2111,1746,365,1266,845,E07000065,E10000011,E12000008,21,"Above 1,000 (b)",11,10
2268,NDWAT,5353,2271,3082,955,4398,E07000115,E10000016,E12000008,29,"Above 3,000 (b)",9,10
2269,NDWES,6455,6333,122,4181,2274,E07000114,E10000016,E12000008,29,"Above 3,000 (b)",9,10
2270,NDWET,2665,1814,851,1501,1164,E09000006,E99999999,E12000007,00London,"Above 1,000 (b)",11,10
2271,NDWHI,12754,9328,3426,4666,8088,E07000106,E10000016,E12000008,29,"Above 10,000 (a)",6,30
2272,NDWIN,2090,1086,1004,136,1954,E07000106,E10000016,E12000008,29,"Above 1,000 (b)",11,10
2273,NDWIT,669,534,135,384,285,E07000105,E10000016,E12000008,29,"Below 1,000 (b)",13,10
2274,NDWKI,2641,2223,418,673,1968,E07000111,E10000016,E12000008,29,"Above 1,000 (b)",11,10
2275,NDWMA,8050,5108,2942,1770,6280,E07000115,E10000016,E12000008,29,"Above 3,000 (b)",9,10
2276,NDWOO,946,807,139,410,536,E07000105,E10000016,E12000008,29,"Below 1,000 (b)",13,10
2277,NDWOR,545,292,253,50,495,E07000113,E10000016,E12000008,29,"Below 1,000 (b)",13,10
2278,NDWYE,1640,1170,470,967,673,E07000105,E10000016,E12000008,29,"Above 1,000 (b)",11,10
2279,NEAC,420,88,332,15,405,E06000057,E99999999,E12000001,00EM,"Below 1,000 (b)",13,10
2280,NEAL,940,855,85,424,516,E06000057,E99999999,E12000001,00EM,"Below 1,000 (b)",13,10
2281,NEALD,836,675,161,519,317,E06000057,E99999999,E12000001,00EM,"Below 1,000 (b)",13,10
2282,NEALH,298,72,226,39,259,E06000057,E99999999,E12000001,00EM,"Below 1,000 (b)",13,10
2283,NEALS,1362,720,642,616,746,E07000030,E10000006,E12000002,16,"Above 1,000 (b)",11,10
2284,NEAM,4173,3354,819,3016,1157,E06000057,E99999999,E12000001,00EM,"Above 3,000 (a)",8,30
2285,NEASG,971,408,563,90,881,E07000166,E10000023,E12000003,36,"Below 1,000 (a)",12,10
2286,NEAT,20282,13084,7198,5101,15181,E06000057,E99999999,E12000001,00EM,"Above 20,000 (b)",5,30
2287,NEAW,4814,4668,146,3138,1676,E06000057,E99999999,E12000001,00EM,"Above 3,000 (a)",8,30
2288,NEAYC,13438,9349,4089,3238,10200,E06000047,E99999999,E12000001,00EJ,"Above 10,000 (b)",7,30
2289,NEB,10607,10605,2,3914,6693,E08000021,E99999999,E12000001,00CJ,Large City,2,50
2290,NEBA,11606,7875,3731,2884,8722,E06000047,E99999999,E12000001,00EJ,"Above 10,000 (b)",7,30
2291,NEBC,3984,3707,277,2882,1102,E06000047,E99999999,E12000001,00EJ,"Above 3,000 (a)",8,30
2292,NEBDL,4030,2468,1562,2184,1846,E07000164,E10000023,E12000003,36,"Above 3,000 (b)",9,10
2293,NEBDT,10537,6720,3817,3766,6771,E06000057,E99999999,E12000001,00EM,"Above 10,000 (a)",6,30
2294,NEBEA,4369,2532,1837,729,3640,E06000047,E99999999,E12000001,00EJ,"Above 3,000 (b)",9,10
2295,NEBED,978,756,222,643,335,E06000057,E99999999,E12000001,00EM,"Below 1,000 (b)",13,10
2296,NEBEL,213,84,129,29,184,E06000057,E99999999,E12000001,00EM,"Below 1,000 (b)",13,10
2297,NEBGM,653,567,86,499,154,E06000057,E99999999,E12000001,00EM,"Below 1,000 (a)",12,10
2298,NEBH,18715,13812,4903,5921,12794,E06000057,E99999999,E12000001,00EM,"Above 10,000 (b)",7,30
2299,NEBHM,421,100,321,79,342,E07000166,E10000023,E12000003,36,"Below 1,000 (b)",13,10
2300,NEBL,8432,7458,974,2843,5589,E08000037,E99999999,E12000001,00CH,"Above 3,000 (b)",9,10
2301,NEBLA,178,76,102,64,114,E06000057,E99999999,E12000001,00EM,"Below 1,000 (b)",13,10
2302,NEBLS,176,73,103,38,138,E06000057,E99999999,E12000001,00EM,"Below 1,000 (b)",13,10
2303,NEBML,556,424,132,176,380,E06000057,E99999999,E12000001,00EM,"Below 1,000 (b)",13,10
2304,NEBNG,643,52,591,17,626,E07000166,E10000023,E12000003,36,"Below 1,000 (b)",13,10
2305,NEBO,21076,8479,12597,2123,18953,E08000024,E99999999,E12000001,00CM,"Above 20,000 (a)",4,30
2306,NEBR,13912,8666,5246,3470,10442,E06000047,E99999999,E12000001,00EJ,"Above 10,000 (b)",7,30
2307,NEBRO,2803,2786,17,2460,343,E06000003,E99999999,E12000001,00EE,"Above 1,000 (b)",11,10
2308,NEBRT,1126,426,700,382,744,E07000166,E10000023,E12000003,36,"Above 1,000 (b)",11,10
2309,NEBU,555,409,146,289,266,E06000057,E99999999,E12000001,00EM,"Below 1,000 (b)",13,10
2310,NEBUR,2771,2516,255,1602,1169,E06000047,E99999999,E12000001,00EJ,"Above 1,000 (b)",11,10
2311,NEBW,7077,5430,1647,2543,4534,E06000057,E99999999,E12000001,00EM,"Above 3,000 (a)",8,30
2312,NEBWS,287,165,122,138,149,E07000166,E10000023,E12000003,36,"Below 1,000 (b)",13,10
2313,NECAP,179,41,138,25,154,E06000057,E99999999,E12000001,00EM,"Below 1,000 (a)",12,10
2314,NECB,2002,1809,193,1546,456,E06000057,E99999999,E12000001,00EM,"Above 1,000 (b)",11,10
2315,NECBN,732,278,454,21,711,E07000166,E10000023,E12000003,36,"Below 1,000 (b)",13,10
2316,NECC,4991,3762,1229,1158,3833,E07000166,E10000023,E12000003,36,"Above 3,000 (b)",9,10
2317,NECFD,1942,906,1036,766,1176,E06000047,E99999999,E12000001,00EJ,"Above 1,000 (b)",11,10
2318,NECHA,385,105,280,30,355,E06000057,E99999999,E12000001,00EM,"Below 1,000 (b)",13,10
2319,NECI,291,69,222,20,271,E06000057,E99999999,E12000001,00EM,"Below 1,000 (b)",13,10
2320,NECM,12977,11642,1335,5519,7458,E06000057,E99999999,E12000001,00EM,"Above 10,000 (a)",6,30
2321,NECN,17219,11666,5553,4645,12574,E06000057,E99999999,E12000001,00EM,"Above 10,000 (b)",7,30
2322,NECOD,470,152,318,81,389,E07000165,E10000023,E12000003,36,"Below 1,000 (b)",13,10
2323,NECOT,2147,1484,663,752,1395,E07000166,E10000023,E12000003,36,"Above 1,000 (a)",10,10
2324,NECOX,5853,3395,2458,571,5282,E06000047,E99999999,E12000001,00EJ,"Above 3,000 (b)",9,10
2325,NECR,6335,5547,788,4046,2289,E06000047,E99999999,E12000001,00EJ,"Above 3,000 (b)",9,10
2326,NECSN,701,330,371,265,436,E06000047,E99999999,E12000001,00EJ,"Below 1,000 (b)",13,10
2327,NECST,810,455,355,291,519,E07000164,E10000023,E12000003,36,"Below 1,000 (b)",13,10
2328,NECT,13204,11231,1973,5828,7376,E06000047,E99999999,E12000001,00EJ,"Above 10,000 (b)",7,30
2329,NECTN,268,130,138,35,233,E06000057,E99999999,E12000001,00EM,"Below 1,000 (b)",13,10
2330,NED,9644,9362,282,4752,4892,E08000037,E99999999,E12000001,00CH,"Above 3,000 (b)",9,10
2331,NEDB,11729,11729,0,6841,4888,E08000021,E99999999,E12000001,00CJ,Large City,2,50
2332,NEDL,45499,25839,19660,8260,37239,E07000166,E10000023,E12000003,36,"Above 20,000 (b)",5,30
2333,NEDN,2826,1966,860,1427,1399,E06000005,E99999999,E12000001,00EH,"Above 1,000 (b)",11,10
2334,NEDP,4561,2386,2175,932,3629,E06000047,E99999999,E12000001,00EJ,"Above 3,000 (b)",9,10
2335,NEDU,15790,10313,5477,3323,12467,E06000047,E99999999,E12000001,00EJ,"Above 10,000 (b)",7,30
2336,NEDUDL,5980,3970,2010,2546,3434,E06000057,E99999999,E12000001,00EM,"Above 3,000 (b)",9,10
2337,NEE,3844,2600,1244,838,3006,E06000057,E99999999,E12000001,00EM,"Above 3,000 (b)",9,10
2338,NEEB,219,80,139,48,171,E06000057,E99999999,E12000001,00EM,"Below 1,000 (b)",13,10
2339,NEEC,11258,7171,4087,3664,7594,E06000004,E99999999,E12000001,00EF,Small City,3,50
2340,NEEGT,506,162,344,18,488,E06000047,E99999999,E12000001,00EJ,"Below 1,000 (b)",13,10
2341,NEEHL,571,127,444,102,469,E07000164,E10000023,E12000003,36,"Below 1,000 (b)",13,10
2342,NEEHN,15436,13046,2390,4675,10761,E08000024,E99999999,E12000001,00CM,"Above 10,000 (b)",7,30
2343,NEELA,614,73,541,42,572,E07000166,E10000023,E12000003,36,"Below 1,000 (b)",13,10
2344,NEEN,876,457,419,285,591,E06000057,E99999999,E12000001,00EM,"Below 1,000 (a)",12,10
2345,NEES,4144,3705,439,2346,1798,E06000047,E99999999,E12000001,00EJ,"Above 3,000 (b)",9,10
2346,NEESG,17627,9495,8132,2308,15319,E06000002,E99999999,E12000001,00EC,Small City,3,50
2347,NEF,21155,13893,7262,5570,15585,E08000037,E99999999,E12000001,00CH,Large City,2,50
2348,NEFEL,1014,518,496,475,539,E06000057,E99999999,E12000001,00EM,"Above 1,000 (b)",11,10
2349,NEFH,6627,5156,1471,3306,3321,E06000047,E99999999,E12000001,00EJ,"Above 3,000 (b)",9,10
2350,NEFN,11101,5465,5636,2087,9014,E06000047,E99999999,E12000001,00EJ,"Above 10,000 (b)",7,30
2351,NEFSL,2060,432,1628,366,1694,E06000047,E99999999,E12000001,00EJ,"Above 1,000 (b)",11,10
2352,NEFT,115,33,82,14,101,E07000030,E10000006,E12000002,16,"Below 1,000 (b)",13,10
2353,NEG,8593,7905,688,4796,3797,E07000164,E10000023,E12000003,36,"Above 3,000 (b)",9,10
2354,NEGA,2620,2309,311,2106,514,E07000164,E10000023,E12000003,36,"Above 1,000 (b)",11,10
2355,NEGF,13770,13729,41,6604,7166,E08000021,E99999999,E12000001,00CJ,Large City,2,50
2356,NEGHD,8945,8945,0,3928,5017,E08000037,E99999999,E12000001,00CH,"Above 3,000 (b)",9,10
2357,NEGLA,666,329,337,202,464,E07000167,E10000023,E12000003,36,"Below 1,000 (b)",13,10
2358,NEGM,10642,7282,3360,2125,8517,E06000001,E99999999,E12000001,00EB,"Above 10,000 (b)",7,30
2359,NEGMT,420,259,161,148,272,E07000168,E10000023,E12000003,36,"Below 1,000 (b)",13,10
2360,NEGND,402,120,282,95,307,E07000166,E10000023,E12000003,36,"Below 1,000 (b)",13,10
2361,NEGNFD,1153,605,548,576,577,E07000166,E10000023,E12000003,36,"Above 1,000 (b)",11,10
2362,NEGRE,299,83,216,37,262,E06000057,E99999999,E12000001,00EM,"Below 1,000 (b)",13,10
2363,NEGS,613,166,447,99,514,E07000166,E10000023,E12000003,36,"Below 1,000 (b)",13,10
2364,NEGTD,285,226,59,198,87,E07000167,E10000023,E12000003,36,"Below 1,000 (b)",13,10
2365,NEGWT,382,105,277,86,296,E06000057,E99999999,E12000001,00EM,"Below 1,000 (a)",12,10
2366,NEHAL,33982,17033,16949,4913,29069,E06000047,E99999999,E12000001,00EJ,"Above 20,000 (b)",5,30
2367,NEHAR,220,117,103,74,146,E06000057,E99999999,E12000001,00EM,"Below 1,000 (b)",13,10
2368,NEHAS,919,709,210,567,352,E07000163,E10000023,E12000003,36,"Below 1,000 (b)",13,10
2369,NEHAY,980,850,130,762,218,E06000057,E99999999,E12000001,00EM,"Below 1,000 (b)",13,10
2370,NEHDL,1609,644,965,343,1266,E06000003,E99999999,E12000001,00EE,"Above 1,000 (b)",11,10
2371,NEHH,811,221,590,24,787,E06000057,E99999999,E12000001,00EM,"Below 1,000 (b)",13,10
2372,NEHHL,1330,807,523,274,1056,E06000004,E99999999,E12000001,00EF,"Above 1,000 (b)",11,10
2373,NEHID,200,171,29,148,52,E06000057,E99999999,E12000001,00EM,"Below 1,000 (b)",13,10
2374,NEHLS,10444,8119,2325,3983,6461,E06000047,E99999999,E12000001,00EJ,"Above 10,000 (b)",7,30
2375,NEHPL,111,44,67,31,80,E06000057,E99999999,E12000001,00EM,"Below 1,000 (b)",13,10
2376,NEHR,259,97,162,34,225,E06000057,E99999999,E12000001,00EM,"Below 1,000 (b)",13,10
2377,NEHRT,13725,11065,2660,5190,8535,E06000004,E99999999,E12000001,00EF,Small City,3,50
2378,NEHSY,472,177,295,14,458,E07000164,E10000023,E12000003,36,"Below 1,000 (b)",13,10
2379,NEHT,10415,5623,4792,2225,8190,E06000047,E99999999,E12000001,00EJ,"Above 10,000 (b)",7,30
2380,NEHTR,1752,932,820,750,1002,E06000004,E99999999,E12000001,00EF,"Above 1,000 (b)",11,10
2381,NEHWH,2338,1980,358,1770,568,E06000057,E99999999,E12000001,00EM,"Above 1,000 (b)",11,10
2382,NEHYL,13721,12481,1240,5747,7974,E08000024,E99999999,E12000001,00CM,"Above 10,000 (b)",7,30
2383,NEHZ,6779,5828,951,4325,2454,E06000057,E99999999,E12000001,00EM,"Above 3,000 (a)",8,30
2384,NEILB,13926,10264,3662,3041,10885,E06000004,E99999999,E12000001,00EF,Small City,3,50
2385,NEJ,9994,9994,0,7228,2766,E08000021,E99999999,E12000001,00CJ,"Above 3,000 (a)",8,30
2386,NEJV,347,112,235,13,334,E07000165,E10000023,E12000003,36,"Below 1,000 (b)",13,10
2387,NEJW,29876,13643,16233,4344,25532,E08000023,E99999999,E12000001,00CL,Large City,2,50
2388,NEK,17421,14680,2741,5846,11575,E08000021,E99999999,E12000001,00CJ,Large City,2,50
2389,NEKBW,708,103,605,16,692,E07000164,E10000023,E12000003,36,"Below 1,000 (b)",13,10
2390,NEKDR,160,117,43,108,52,E06000057,E99999999,E12000001,00EM,"Below 1,000 (a)",12,10
2391,NEKF,1061,332,729,71,990,E07000164,E10000023,E12000003,36,"Above 1,000 (b)",11,10
2392,NEKI,14781,10292,4489,4648,10133,E06000057,E99999999,E12000001,00EM,"Above 10,000 (b)",7,30
2393,NEKP,208,112,96,82,126,E06000057,E99999999,E12000001,00EM,"Below 1,000 (b)",13,10
2394,NEL,14827,13066,1761,6493,8334,E08000037,E99999999,E12000001,00CH,Large City,2,50
2395,NELC,3034,1923,1111,1682,1352,E06000047,E99999999,E12000001,00EJ,"Above 3,000 (b)",9,10
2396,NELEB,2514,1477,1037,1118,1396,E07000166,E10000023,E12000003,36,"Above 1,000 (b)",11,10
2397,NELF,18380,16190,2190,6085,12295,E08000024,E99999999,E12000001,00CM,"Above 10,000 (b)",7,30
2398,NELIN,20169,19151,1018,9241,10928,E06000004,E99999999,E12000001,00EF,Small City,3,50
2399,NELK,381,257,124,209,172,E06000057,E99999999,E12000001,00EM,"Below 1,000 (b)",13,10
2400,NELL,563,358,205,303,260,E06000057,E99999999,E12000001,00EM,"Below 1,000 (b)",13,10
2401,NELM,2268,2125,143,929,1339,E06000057,E99999999,E12000001,00EM,"Above 1,000 (a)",10,10
2402,NELO,821,598,223,520,301,E06000057,E99999999,E12000001,00EM,"Below 1,000 (b)",13,10
2403,NELOF,4019,3276,743,2357,1662,E06000003,E99999999,E12000001,00EE,"Above 3,000 (b)",9,10
2404,NELT,734,581,153,502,232,E06000057,E99999999,E12000001,00EM,"Below 1,000 (b)",13,10
2405,NEMEA,5719,5029,690,2880,2839,E06000047,E99999999,E12000001,00EJ,"Above 3,000 (b)",9,10
2406,NEMI,14334,12897,1437,6632,7702,E06000004,E99999999,E12000001,00EF,Small City,3,50
2407,NEMIL,374,167,207,87,287,E06000057,E99999999,E12000001,00EM,"Below 1,000 (b)",13,10
2408,NEMP,9557,7071,2486,3389,6168,E06000057,E99999999,E12000001,00EM,"Above 3,000 (a)",8,30
2409,NEMTD,1129,677,452,467,662,E06000047,E99999999,E12000001,00EJ,"Above 1,000 (b)",11,10
2410,NEMTN,21574,12972,8602,3840,17734,E07000164,E10000023,E12000003,36,"Above 20,000 (b)",5,30
2411,NENA,9887,8333,1554,5411,4476,E07000164,E10000023,E12000003,36,"Above 3,000 (a)",8,30
2412,NENB,534,391,143,311,223,E06000057,E99999999,E12000001,00EM,"Below 1,000 (b)",13,10
2413,NENCT,650,300,350,180,470,E07000166,E10000023,E12000003,36,"Below 1,000 (b)",13,10
2414,NENH,216,94,122,60,156,E06000057,E99999999,E12000001,00EM,"Below 1,000 (b)",13,10
2415,NENN,16943,14173,2770,5629,11314,E06000004,E99999999,E12000001,00EF,Small City,3,50
2416,NENP,7996,3393,4603,112,7884,E06000047,E99999999,E12000001,00EJ,"Above 3,000 (b)",9,10
2417,NENR,514,382,132,302,212,E06000057,E99999999,E12000001,00EM,"Below 1,000 (b)",13,10
2418,NENS,24000,18848,5152,8408,15592,E08000023,E99999999,E12000001,00CL,Large City,2,50
2419,NENT,7473,7473,0,6297,1176,E08000037,E99999999,E12000001,00CH,"Above 3,000 (a)",8,30
2420,NENTE,19787,18329,1458,9662,10125,E08000021,E99999999,E12000001,00CJ,Large City,2,50
2421,NENTW,13826,13825,1,9040,4786,E08000037,E99999999,E12000001,00CH,Large City,2,50
2422,NEOC,2887,1611,1276,877,2010,E07000166,E10000023,E12000003,36,"Above 1,000 (b)",11,10
2423,NEOM,540,345,195,57,483,E07000164,E10000023,E12000003,36,"Below 1,000 (b)",13,10
2424,NEON,525,258,267,247,278,E06000057,E99999999,E12000001,00EM,"Below 1,000 (b)",13,10
2425,NEP,5269,3102,2167,1937,3332,E06000057,E99999999,E12000001,00EM,"Above 3,000 (b)",9,10
2426,NEPB,448,162,286,114,334,E06000057,E99999999,E12000001,00EM,"Below 1,000 (b)",13,10
2427,NEPG,906,141,765,67,839,E07000166,E10000023,E12000003,36,"Below 1,000 (b)",13,10
2428,NEPH,5621,5494,127,3676,1945,E06000057,E99999999,E12000001,00EM,"Above 3,000 (b)",9,10
2429,NEPTE,15801,12313,3488,4414,11387,E06000047,E99999999,E12000001,00EJ,"Above 10,000 (b)",7,30
2430,NEPX,681,227,454,150,531,E06000057,E99999999,E12000001,00EM,"Below 1,000 (b)",13,10
2431,NERB,1649,1270,379,1006,643,E06000057,E99999999,E12000001,00EM,"Above 1,000 (b)",11,10
2432,NERC,18386,11314,7072,4408,13978,E06000003,E99999999,E12000001,00EE,Small City,3,50
2433,NERD,1791,1360,431,1134,657,E06000057,E99999999,E12000001,00EM,"Above 1,000 (a)",10,10
2434,NERE,9451,8436,1015,4058,5393,E06000047,E99999999,E12000001,00EJ,"Above 3,000 (b)",9,10
2435,NEREH,753,445,308,361,392,E07000166,E10000023,E12000003,36,"Below 1,000 (b)",13,10
2436,NERFD,2659,2149,510,1939,720,E06000047,E99999999,E12000001,00EJ,"Above 1,000 (b)",11,10
2437,NERG,3960,2923,1037,1991,1969,E06000047,E99999999,E12000001,00EJ,"Above 3,000 (b)",9,10
2438,NERHB,1158,822,336,689,469,E07000168,E10000023,E12000003,36,"Above 1,000 (b)",11,10
2439,NERM,606,461,145,385,221,E06000057,E99999999,E12000001,00EM,"Below 1,000 (b)",13,10
2440,NERN,5258,4565,693,3375,1883,E07000166,E10000023,E12000003,36,"Above 3,000 (a)",8,30
2441,NERT,10117,6786,3331,2649,7468,E06000057,E99999999,E12000001,00EM,"Above 10,000 (b)",7,30
2442,NES,16391,15059,1332,6509,9882,E06000004,E99999999,E12000001,00EF,Small City,3,50
2443,NESAC,5072,4481,591,2701,2371,E06000047,E99999999,E12000001,00EJ,"Above 3,000 (b)",9,10
2444,NESAI,8672,8021,651,1963,6709,E06000004,E99999999,E12000001,00EF,Small City,3,50
2445,NESBY,632,181,451,36,596,E07000165,E10000023,E12000003,36,"Below 1,000 (b)",13,10
2446,NESDP,801,643,158,594,207,E06000047,E99999999,E12000001,00EJ,"Below 1,000 (b)",13,10
2447,NESEH,2132,1451,681,1207,925,E06000057,E99999999,E12000001,00EM,"Above 1,000 (b)",11,10
2448,NESFE,4172,2366,1806,1996,2176,E06000047,E99999999,E12000001,00EJ,"Above 3,000 (b)",9,10
2449,NESG,267,138,129,78,189,E06000057,E99999999,E12000001,00EM,"Below 1,000 (b)",13,10
2450,NESGT,773,294,479,221,552,E06000057,E99999999,E12000001,00EM,"Below 1,000 (b)",13,10
2451,NESH,7085,6409,676,2515,4570,E06000047,E99999999,E12000001,00EJ,"Above 3,000 (b)",9,10
2452,NESHB,1082,830,252,618,464,E06000057,E99999999,E12000001,00EM,"Above 1,000 (b)",11,10
2453,NESHL,6555,4043,2512,1546,5009,E06000047,E99999999,E12000001,00EJ,"Above 3,000 (b)",9,10
2454,NESHM,11295,8295,3000,3911,7384,E06000047,E99999999,E12000001,00EJ,"Above 10,000 (a)",6,30
2455,NESK,5963,3786,2177,1833,4130,E06000003,E99999999,E12000001,00EE,"Above 3,000 (b)",9,10
2456,NESLB,6807,3247,3560,2771,4036,E06000003,E99999999,E12000001,00EE,Small City,3,50
2457,NESLN,1468,555,913,491,977,E06000047,E99999999,E12000001,00EJ,"Above 1,000 (b)",11,10
2458,NESLS,1454,1300,154,892,562,E07000168,E10000023,E12000003,36,"Above 1,000 (b)",11,10
2459,NESLY,506,201,305,145,361,E06000057,E99999999,E12000001,00EM,"Below 1,000 (b)",13,10
2460,NESNS,510,378,132,143,367,E07000168,E10000023,E12000003,36,"Below 1,000 (b)",13,10
2461,NESP,10289,8990,1299,4572,5717,E06000047,E99999999,E12000001,00EJ,"Above 10,000 (b)",7,30
2462,NESS,28687,17358,11329,8974,19713,E08000023,E99999999,E12000001,00CL,Large City,2,50
2463,NESSDS,78,60,18,6,72,E06000001,E99999999,E12000001,00EB,"Below 1,000 (b)",13,10
2464,NESTA,582,264,318,220,362,E06000057,E99999999,E12000001,00EM,"Below 1,000 (b)",13,10
2465,NESTK,2137,1693,444,977,1160,E06000057,E99999999,E12000001,00EM,"Above 1,000 (b)",11,10
2466,NESTN,12350,10219,2131,4425,7925,E06000047,E99999999,E12000001,00EJ,"Above 10,000 (b)",7,30
2467,NESTO,2932,2633,299,2208,724,E07000164,E10000023,E12000003,36,"Above 1,000 (b)",11,10
2468,NESU,17167,16703,464,4967,12200,E08000024,E99999999,E12000001,00CM,"Above 10,000 (a)",6,30
2469,NESUN,15883,13426,2457,4154,11729,E08000024,E99999999,E12000001,00CM,"Above 10,000 (a)",6,30
2470,NESUT,508,206,302,109,399,E07000164,E10000023,E12000003,36,"Below 1,000 (b)",13,10
2471,NESVL,6796,4943,1853,339,6457,E06000057,E99999999,E12000001,00EM,"Above 3,000 (b)",9,10
2472,NETI,5476,4970,506,3518,1958,E07000164,E10000023,E12000003,36,"Above 3,000 (a)",8,30
2473,NETL,5560,2770,2790,1549,4011,E06000047,E99999999,E12000001,00EJ,"Above 3,000 (b)",9,10
2474,NETMN,2974,1571,1403,953,2021,E06000047,E99999999,E12000001,00EJ,"Above 1,000 (b)",11,10
2475,NETP,1380,432,948,356,1024,E07000165,E10000023,E12000003,36,"Above 1,000 (b)",11,10
2476,NETW,2251,1223,1028,1022,1229,E06000047,E99999999,E12000001,00EJ,"Above 1,000 (b)",11,10
2477,NEUL,546,122,424,20,526,E07000164,E10000023,E12000003,36,"Below 1,000 (b)",13,10
2478,NEULM,1722,415,1307,143,1579,E06000057,E99999999,E12000001,00EM,"Above 1,000 (b)",11,10
2479,NEW,20546,14779,5767,6743,13803,E08000023,E99999999,E12000001,00CL,Large City,2,50
2480,NEWAS,20926,15918,5008,5132,15794,E08000024,E99999999,E12000001,00CM,"Above 20,000 (b)",5,30
2481,NEWAU,4839,2896,1943,1768,3071,E06000047,E99999999,E12000001,00EJ,"Above 3,000 (b)",9,10
2482,NEWB,24122,19126,4996,7370,16752,E08000022,E99999999,E12000001,00CK,Large City,2,50
2483,NEWF,212,68,144,24,188,E06000057,E99999999,E12000001,00EM,"Below 1,000 (b)",13,10
2484,NEWGM,431,197,234,16,415,E06000057,E99999999,E12000001,00EM,"Below 1,000 (b)",13,10
2485,NEWH,289,138,151,112,177,E06000057,E99999999,E12000001,00EM,"Below 1,000 (b)",13,10
2486,NEWHD,640,363,277,206,434,E06000047,E99999999,E12000001,00EJ,"Below 1,000 (b)",13,10
2487,NEWHP,10132,7316,2816,2407,7725,E08000021,E99999999,E12000001,00CJ,"Above 10,000 (b)",7,30
2488,NEWHY,8050,7772,278,4796,3254,E07000168,E10000023,E12000003,36,"Above 3,000 (a)",8,30
2489,NEWK,9593,7939,1654,5082,4511,E08000037,E99999999,E12000001,00CH,"Above 3,000 (b)",9,10
2490,NEWLF,3549,2916,633,1796,1753,E06000047,E99999999,E12000001,00EJ,"Above 3,000 (b)",9,10
2491,NEWLL,426,161,265,103,323,E07000164,E10000023,E12000003,36,"Below 1,000 (b)",13,10
2492,NEWLW,1517,594,923,278,1239,E06000047,E99999999,E12000001,00EJ,"Above 1,000 (b)",11,10
2493,NEWN,7425,6772,653,1159,6266,E08000024,E99999999,E12000001,00CM,"Above 3,000 (b)",9,10
2494,NEWNS,849,472,377,79,770,E07000164,E10000023,E12000003,36,"Below 1,000 (b)",13,10
2495,NEWO,1421,1266,155,1129,292,E06000057,E99999999,E12000001,00EM,"Above 1,000 (a)",10,10
2496,NEWOP,176,61,115,9,167,E06000057,E99999999,E12000001,00EM,"Below 1,000 (b)",13,10
2497,NEWOR,351,124,227,77,274,E07000166,E10000023,E12000003,36,"Below 1,000 (b)",13,10
2498,NEWR,582,301,281,261,321,E06000057,E99999999,E12000001,00EM,"Below 1,000 (b)",13,10
2499,NEWT,4700,3696,1004,2701,1999,E06000047,E99999999,E12000001,00EJ,"Above 3,000 (b)",9,10
2500,NEWU,311,186,125,90,221,E06000057,E99999999,E12000001,00EM,"Below 1,000 (b)",13,10
2501,NEWV,12601,10044,2557,2261,10340,E06000047,E99999999,E12000001,00EJ,"Above 10,000 (b)",7,30
2502,NEWYL,1713,1039,674,896,817,E06000057,E99999999,E12000001,00EM,"Above 1,000 (b)",11,10
2503,NSABC,901,629,272,603,298,S12000034,S99999999,S99999999,00QB,"Below 1,000 (b)",13,10
2504,NSABL,1105,689,416,509,596,S12000020,S99999999,S99999999,00QX,"Above 1,000 (a)",10,10
2505,NSABO,1652,1478,174,700,952,S12000034,S99999999,S99999999,00QB,"Above 1,000 (b)",11,10
2506,NSADV,121,27,94,0,121,S12000017,S99999999,S99999999,00QT,"Below 1,000 (b)",13,10
2507,NSAGR,138,50,88,6,132,S12000017,S99999999,S99999999,00QT,"Below 1,000 (b)",13,10
2508,NSAGY,644,409,235,270,374,S12000017,S99999999,S99999999,00QT,"Below 1,000 (b)",13,10
2509,NSALB,500,109,391,93,407,S12000017,S99999999,S99999999,00QT,"Below 1,000 (b)",13,10
2510,NSALF,2023,1491,532,1242,781,S12000034,S99999999,S99999999,00QB,"Above 1,000 (a)",10,10
2511,NSALG,67,0,67,0,67,S12000017,S99999999,S99999999,00QT,"Below 1,000 (b)",13,10
2512,NSALR,223,35,188,8,215,S12000034,S99999999,S99999999,00QB,"Below 1,000 (b)",13,10
2513,NSALT,36,0,36,0,36,S12000017,S99999999,S99999999,00QT,"Below 1,000 (b)",13,10
2514,NSALV,497,186,311,48,449,S12000020,S99999999,S99999999,00QX,"Below 1,000 (b)",13,10
2515,NSANG,347,105,242,62,285,S12000034,S99999999,S99999999,00QB,"Below 1,000 (b)",13,10
2516,NSANS,3111,2604,507,1847,1264,S12000017,S99999999,S99999999,00QT,"Above 3,000 (a)",8,30
2517,NSAPP,168,92,76,37,131,S12000017,S99999999,S99999999,00QT,"Below 1,000 (b)",13,10
2518,NSARI,374,147,227,147,227,S12000017,S99999999,S99999999,00QT,"Below 1,000 (b)",13,10
2519,NSASC,48,0,48,0,48,S12000017,S99999999,S99999999,00QT,"Below 1,000 (b)",13,10
2520,NSASH,16441,15500,941,6130,10311,S12000033,S99999999,S99999999,00QA,Small City,3,50
2521,NSASN,41,15,26,4,37,S12000017,S99999999,S99999999,00QT,"Below 1,000 (b)",13,10
2522,NSASR,754,578,176,390,364,S12000017,S99999999,S99999999,00QT,"Below 1,000 (b)",13,10
2523,NSASS,21,17,4,17,4,S12000017,S99999999,S99999999,00QT,"Below 1,000 (b)",13,10
2524,NSATB,196,48,148,32,164,S12000017,S99999999,S99999999,00QT,"Below 1,000 (b)",13,10
2525,NSATL,301,69,232,40,261,S12000034,S99999999,S99999999,00QB,"Below 1,000 (b)",13,10
2526,NSAVI,2236,2009,227,1383,853,S12000017,S99999999,S99999999,00QT,"Above 1,000 (a)",10,10
2527,NSAVR,245,92,153,49,196,S12000017,S99999999,S99999999,00QT,"Below 1,000 (b)",13,10
2528,NSBAC,951,410,541,215,736,S12000013,S99999999,S99999999,00RJ,"Below 1,000 (b)",13,10
2529,NSBAD,166,60,106,36,130,S12000017,S99999999,S99999999,00QT,"Below 1,000 (b)",13,10
2530,NSBAY,236,28,208,11,225,S12000013,S99999999,S99999999,00RJ,"Below 1,000 (b)",13,10
2531,NSBBN,8868,7700,1168,2936,5932,S12000033,S99999999,S99999999,00QA,Small City,3,50
2532,NSBCS,622,284,338,265,357,S12000017,S99999999,S99999999,00QT,"Below 1,000 (b)",13,10
2533,NSBCY,4083,3029,1054,1308,2775,S12000034,S99999999,S99999999,00QB,"Above 3,000 (a)",8,30
2534,NSBDI,529,156,373,32,497,S12000020,S99999999,S99999999,00QX,"Below 1,000 (b)",13,10
2535,NSBDS,3294,3140,154,1939,1355,S12000033,S99999999,S99999999,00QA,"Above 3,000 (b)",9,10
2536,NSBEA,1164,961,203,805,359,S12000017,S99999999,S99999999,00QT,"Above 1,000 (b)",11,10
2537,NSBEN,617,308,309,88,529,S12000013,S99999999,S99999999,00RJ,"Below 1,000 (b)",13,10
2538,NSBER,81,7,74,0,81,S12000017,S99999999,S99999999,00QT,"Below 1,000 (b)",13,10
2539,NSBET,287,125,162,67,220,S12000017,S99999999,S99999999,00QT,"Below 1,000 (b)",13,10
2540,NSBFD,841,375,466,217,624,S12000017,S99999999,S99999999,00QT,"Below 1,000 (b)",13,10
2541,NSBFR,169,57,112,27,142,S12000023,S99999999,S99999999,00RA,"Below 1,000 (b)",13,10
2542,NSBIG,277,107,170,64,213,S12000027,S99999999,S99999999,00RD,"Below 1,000 (b)",13,10
2543,NSBIR,276,123,153,25,251,S12000023,S99999999,S99999999,00RA,"Below 1,000 (a)",12,10
2544,NSBIX,245,40,205,33,212,S12000027,S99999999,S99999999,00RD,"Below 1,000 (b)",13,10
2545,NSBKI,5273,4488,785,2410,2863,S12000020,S99999999,S99999999,00QX,"Above 3,000 (a)",8,30
2546,NSBLD,162,93,69,17,145,S12000020,S99999999,S99999999,00QX,"Below 1,000 (a)",12,10
2547,NSBLG,8869,7348,1521,3078,5791,S12000033,S99999999,S99999999,00QA,Small City,3,50
2548,NSBLL,347,52,295,52,295,S12000013,S99999999,S99999999,00RJ,"Below 1,000 (b)",13,10
2549,NSBLT,1234,1088,146,1007,227,S12000034,S99999999,S99999999,00QB,"Above 1,000 (b)",11,10
2550,NSBMC,180,89,91,4,176,S12000017,S99999999,S99999999,00QT,"Below 1,000 (b)",13,10
2551,NSBMD,1960,1179,781,904,1056,S12000034,S99999999,S99999999,00QB,"Above 1,000 (a)",10,10
2552,NSBMR,436,368,68,299,137,S12000034,S99999999,S99999999,00QB,"Below 1,000 (a)",12,10
2553,NSBNF,2309,2265,44,2167,142,S12000034,S99999999,S99999999,00QB,"Above 1,000 (a)",10,10
2554,NSBNS,136,36,100,21,115,S12000013,S99999999,S99999999,00RJ,"Below 1,000 (b)",13,10
2555,NSBOG,480,360,120,338,142,S12000017,S99999999,S99999999,00QT,"Below 1,000 (a)",12,10
2556,NSBOW,180,50,130,50,130,S12000017,S99999999,S99999999,00QT,"Below 1,000 (a)",12,10
2557,NSBRA,489,392,97,164,325,S12000027,S99999999,S99999999,00RD,"Below 1,000 (a)",12,10
2558,NSBRK,500,84,416,24,476,S12000017,S99999999,S99999999,00QT,"Below 1,000 (b)",13,10
2559,NSBRN,138,118,20,51,87,S12000013,S99999999,S99999999,00RJ,"Below 1,000 (b)",13,10
2560,NSBRR,1009,882,127,714,295,S12000017,S99999999,S99999999,00QT,"Above 1,000 (a)",10,10
2561,NSBRV,308,121,187,28,280,S12000013,S99999999,S99999999,00RJ,"Below 1,000 (b)",13,10
2562,NSBRY,275,213,62,159,116,S12000023,S99999999,S99999999,00RA,"Below 1,000 (a)",12,10
2563,NSBSY,190,97,93,50,140,S12000027,S99999999,S99999999,00RD,"Below 1,000 (b)",13,10
2564,NSBTS,338,172,166,48,290,S12000027,S99999999,S99999999,00RD,"Below 1,000 (b)",13,10
2565,NSBVO,264,94,170,24,240,S12000027,S99999999,S99999999,00RD,"Below 1,000 (b)",13,10
2566,NSBVS,307,179,128,109,198,S12000013,S99999999,S99999999,00RJ,"Below 1,000 (b)",13,10
2567,NSCAB,63,12,51,5,58,S12000034,S99999999,S99999999,00QB,"Below 1,000 (b)",13,10
2568,NSCAL,255,96,159,67,188,S12000013,S99999999,S99999999,00RJ,"Below 1,000 (b)",13,10
2569,NSCAN,203,92,111,92,111,S12000017,S99999999,S99999999,00QT,"Below 1,000 (b)",13,10
2570,NSCAR,219,91,128,35,184,S12000017,S99999999,S99999999,00QT,"Below 1,000 (b)",13,10
2571,NSCAT,394,159,235,45,349,S12000034,S99999999,S99999999,00QB,"Below 1,000 (b)",13,10
2572,NSCAW,429,153,276,37,392,S12000017,S99999999,S99999999,00QT,"Below 1,000 (b)",13,10
2573,NSCBK,600,354,246,278,322,S12000017,S99999999,S99999999,00QT,"Below 1,000 (b)",13,10
2574,NSCBS,467,161,306,74,393,S12000013,S99999999,S99999999,00RJ,"Below 1,000 (b)",13,10
2575,NSCBY,438,240,198,178,260,S12000013,S99999999,S99999999,00RJ,"Below 1,000 (b)",13,10
2576,NSCGM,74,0,74,0,74,S12000017,S99999999,S99999999,00QT,"Below 1,000 (b)",13,10
2577,NSCHL,381,155,226,110,271,S12000034,S99999999,S99999999,00QB,"Below 1,000 (b)",13,10
2578,NSCLN,1697,893,804,793,904,S12000034,S99999999,S99999999,00QB,"Above 1,000 (b)",11,10
2579,NSCLO,650,118,532,44,606,S12000020,S99999999,S99999999,00QX,"Below 1,000 (b)",13,10
2580,NSCNI,195,88,107,61,134,S12000034,S99999999,S99999999,00QB,"Below 1,000 (b)",13,10
2581,NSCPC,2398,1968,430,875,1523,S12000017,S99999999,S99999999,00QT,"Above 1,000 (b)",11,10
2582,NSCPY,200,87,113,43,157,S12000034,S99999999,S99999999,00QB,"Below 1,000 (b)",13,10
2583,NSCRB,407,336,71,260,147,S12000017,S99999999,S99999999,00QT,"Below 1,000 (a)",12,10
2584,NSCRN,431,100,331,8,423,S12000013,S99999999,S99999999,00RJ,"Below 1,000 (b)",13,10
2585,NSCRR,407,109,298,74,333,S12000020,S99999999,S99999999,00QX,"Below 1,000 (b)",13,10
2586,NSCRU,1044,866,178,735,309,S12000034,S99999999,S99999999,00QB,"Above 1,000 (a)",10,10
2587,NSCRY,658,313,345,222,436,S12000017,S99999999,S99999999,00QT,"Below 1,000 (b)",13,10
2588,NSCTI,190,39,151,29,161,S12000034,S99999999,S99999999,00QB,"Below 1,000 (b)",13,10
2589,NSCTN,212,156,56,76,136,S12000034,S99999999,S99999999,00QB,"Below 1,000 (b)",13,10
2590,NSCTR,3729,2505,1224,906,2823,S12000033,S99999999,S99999999,00QA,"Above 3,000 (a)",8,30
2591,NSCTS,310,131,179,64,246,S12000034,S99999999,S99999999,00QB,"Below 1,000 (b)",13,10
2592,NSCTW,670,468,202,422,248,S12000017,S99999999,S99999999,00QT,"Below 1,000 (b)",13,10
2593,NSCTY,475,439,36,413,62,S12000017,S99999999,S99999999,00QT,"Below 1,000 (a)",12,10
2594,NSCUM,769,367,402,275,494,S12000034,S99999999,S99999999,00QB,"Below 1,000 (a)",12,10
2595,NSCUN,321,163,158,62,259,S12000027,S99999999,S99999999,00RD,"Below 1,000 (b)",13,10
2596,NSCWY,247,121,126,19,228,S12000013,S99999999,S99999999,00RJ,"Below 1,000 (b)",13,10
2597,NSDAV,832,38,794,0,832,S12000017,S99999999,S99999999,00QT,"Below 1,000 (b)",13,10
2598,NSDBG,109,68,41,22,87,S12000017,S99999999,S99999999,00QT,"Below 1,000 (b)",13,10
2599,NSDBL,178,56,122,23,155,S12000034,S99999999,S99999999,00QB,"Below 1,000 (b)",13,10
2600,NSDBT,211,162,49,64,147,S12000017,S99999999,S99999999,00QT,"Below 1,000 (b)",13,10
2601,NSDCH,762,427,335,67,695,S12000017,S99999999,S99999999,00QT,"Below 1,000 (b)",13,10
2602,NSDCR,135,0,135,0,135,S12000017,S99999999,S99999999,00QT,"Below 1,000 (b)",13,10
2603,NSDCT,835,666,169,367,468,S12000017,S99999999,S99999999,00QT,"Below 1,000 (b)",13,10
2604,NSDDL,151,12,139,0,151,S12000017,S99999999,S99999999,00QT,"Below 1,000 (b)",13,10
2605,NSDEE,255,109,146,59,196,S12000023,S99999999,S99999999,00RA,"Below 1,000 (b)",13,10
2606,NSDEN,12942,12940,2,9433,3509,S12000033,S99999999,S99999999,00QA,Small City,3,50
2607,NSDET,594,175,419,75,519,S12000034,S99999999,S99999999,00QB,"Below 1,000 (b)",13,10
2608,NSDGW,4608,3010,1598,1824,2784,S12000017,S99999999,S99999999,00QT,"Above 3,000 (a)",8,30
2609,NSDIA,87,0,87,0,87,S12000017,S99999999,S99999999,00QT,"Below 1,000 (b)",13,10
2610,NSDLS,331,54,277,0,331,S12000020,S99999999,S99999999,00QX,"Below 1,000 (b)",13,10
2611,NSDLT,449,205,244,180,269,S12000034,S99999999,S99999999,00QB,"Below 1,000 (b)",13,10
2612,NSDMK,964,551,413,441,523,S12000033,S99999999,S99999999,00QA,"Below 1,000 (b)",13,10
2613,NSDMR,168,92,76,42,126,S12000034,S99999999,S99999999,00QB,"Below 1,000 (b)",13,10
2614,NSDNC,1315,885,430,670,645,S12000017,S99999999,S99999999,00QT,"Above 1,000 (a)",10,10
2615,NSDNI,284,195,89,134,150,S12000017,S99999999,S99999999,00QT,"Below 1,000 (a)",12,10
2616,NSDNS,225,162,63,99,126,S12000017,S99999999,S99999999,00QT,"Below 1,000 (a)",12,10
2617,NSDOC,214,72,142,38,176,S12000017,S99999999,S99999999,00QT,"Below 1,000 (b)",13,10
2618,NSDPH,177,41,136,41,136,S12000020,S99999999,S99999999,00QX,"Below 1,000 (b)",13,10
2619,NSDRN,79,51,28,6,73,S12000013,S99999999,S99999999,00RJ,"Below 1,000 (b)",13,10
2620,NSDRS,140,84,56,68,72,S12000017,S99999999,S99999999,00QT,"Below 1,000 (b)",13,10
2621,NSDTU,170,19,151,11,159,S12000017,S99999999,S99999999,00QT,"Below 1,000 (b)",13,10
2622,NSDUF,1104,963,141,881,223,S12000020,S99999999,S99999999,00QX,"Above 1,000 (b)",11,10
2623,NSDUL,247,205,42,67,180,S12000017,S99999999,S99999999,00QT,"Below 1,000 (a)",12,10
2624,NSDVG,364,197,167,70,294,S12000017,S99999999,S99999999,00QT,"Below 1,000 (b)",13,10
2625,NSDWH,100,11,89,7,93,S12000024,S99999999,S99999999,00RB,"Below 1,000 (b)",13,10
2626,NSDYC,3575,3385,190,1479,2096,S12000033,S99999999,S99999999,00QA,"Above 3,000 (b)",9,10
2627,NSEDD,197,111,86,80,117,S12000017,S99999999,S99999999,00QT,"Below 1,000 (b)",13,10
2628,NSEDI,249,94,155,47,202,S12000017,S99999999,S99999999,00QT,"Below 1,000 (b)",13,10
2629,NSEDN,292,76,216,7,285,S12000034,S99999999,S99999999,00QB,"Below 1,000 (b)",13,10
2630,NSEDY,112,52,60,0,112,S12000023,S99999999,S99999999,00RA,"Below 1,000 (b)",13,10
2631,NSELG,12559,9977,2582,2682,9877,S12000020,S99999999,S99999999,00QX,"Above 10,000 (a)",6,30
2632,NSELL,5125,4828,297,2923,2202,S12000034,S99999999,S99999999,00QB,"Above 3,000 (b)",9,10
2633,NSERI,190,96,94,76,114,S12000013,S99999999,S99999999,00RJ,"Below 1,000 (a)",12,10
2634,NSEVA,915,652,263,574,341,S12000017,S99999999,S99999999,00QT,"Below 1,000 (a)",12,10
2635,NSEVI,283,82,201,43,240,S12000023,S99999999,S99999999,00RA,"Below 1,000 (b)",13,10
2636,NSFAG,455,346,109,300,155,S12000017,S99999999,S99999999,00QT,"Below 1,000 (b)",13,10
2637,NSFAR,299,124,175,49,250,S12000017,S99999999,S99999999,00QT,"Below 1,000 (b)",13,10
2638,NSFET,64,64,0,64,0,S12000027,S99999999,S99999999,00RD,"Below 1,000 (a)",12,10
2639,NSFEU,337,68,269,12,325,S12000034,S99999999,S99999999,00QB,"Below 1,000 (b)",13,10
2640,NSFIN,1469,801,668,333,1136,S12000020,S99999999,S99999999,00QX,"Above 1,000 (b)",11,10
2641,NSFIS,33,33,0,0,33,S12000027,S99999999,S99999999,00RD,"Below 1,000 (b)",13,10
2642,NSFOC,1542,1119,423,895,647,S12000020,S99999999,S99999999,00QX,"Above 1,000 (b)",11,10
2643,NSFOU,27,27,0,0,27,S12000027,S99999999,S99999999,00RD,"Below 1,000 (b)",13,10
2644,NSFRA,6538,6114,424,3314,3224,S12000034,S99999999,S99999999,00QB,"Above 3,000 (b)",9,10
2645,NSFRG,238,90,148,42,196,S12000034,S99999999,S99999999,00QB,"Below 1,000 (b)",13,10
2646,NSFRN,1015,232,783,192,823,S12000017,S99999999,S99999999,00QT,"Above 1,000 (b)",11,10
2647,NSFRS,5597,5237,360,3393,2204,S12000020,S99999999,S99999999,00QX,"Above 3,000 (a)",8,30
2648,NSFSE,1861,1214,647,927,934,S12000017,S99999999,S99999999,00QT,"Above 1,000 (a)",10,10
2649,NSFSS,137,64,73,40,97,S12000017,S99999999,S99999999,00QT,"Below 1,000 (b)",13,10
2650,NSFTN,718,350,368,287,431,S12000023,S99999999,S99999999,00RA,"Below 1,000 (b)",13,10
2651,NSFWM,3021,2775,246,1523,1498,S12000017,S99999999,S99999999,00QT,"Above 3,000 (a)",8,30
2652,NSFYV,728,339,389,260,468,S12000034,S99999999,S99999999,00QB,"Below 1,000 (b)",13,10
2653,NSGAI,464,325,139,102,362,S12000017,S99999999,S99999999,00QT,"Below 1,000 (b)",13,10
2654,NSGBD,140,39,101,0,140,S12000017,S99999999,S99999999,00QT,"Below 1,000 (b)",13,10
2655,NSGBT,1059,278,781,112,947,S12000013,S99999999,S99999999,00RJ,"Above 1,000 (b)",11,10
2656,NSGDL,292,40,252,14,278,S12000017,S99999999,S99999999,00QT,"Below 1,000 (a)",12,10
2657,NSGFN,137,34,103,26,111,S12000017,S99999999,S99999999,00QT,"Below 1,000 (b)",13,10
2658,NSGIL,215,42,173,9,206,S12000017,S99999999,S99999999,00QT,"Below 1,000 (b)",13,10
2659,NSGKD,151,82,69,26,125,S12000034,S99999999,S99999999,00QB,"Below 1,000 (a)",12,10
2660,NSGLA,122,46,76,14,108,S12000034,S99999999,S99999999,00QB,"Below 1,000 (b)",13,10
2661,NSGLG,213,73,140,58,155,S12000017,S99999999,S99999999,00QT,"Below 1,000 (b)",13,10
2662,NSGLV,283,76,207,39,244,S12000020,S99999999,S99999999,00QX,"Below 1,000 (b)",13,10
2663,NSGMT,141,78,63,24,117,S12000017,S99999999,S99999999,00QT,"Below 1,000 (b)",13,10
2664,NSGMZ,57,10,47,0,57,S12000017,S99999999,S99999999,00QT,"Below 1,000 (b)",13,10
2665,NSGOL,953,762,191,695,258,S12000017,S99999999,S99999999,00QT,"Below 1,000 (a)",12,10
2666,NSGOR,397,39,358,6,391,S12000017,S99999999,S99999999,00QT,"Below 1,000 (b)",13,10
2667,NSGOS,1653,1407,246,1239,414,S12000017,S99999999,S99999999,00QT,"Above 1,000 (a)",10,10
2668,NSGOT,477,170,307,87,390,S12000027,S99999999,S99999999,00RD,"Below 1,000 (b)",13,10
2669,NSGQT,245,70,175,0,245,S12000017,S99999999,S99999999,00QT,"Below 1,000 (b)",13,10
2670,NSGRE,231,46,185,41,190,S12000013,S99999999,S99999999,00RJ,"Below 1,000 (b)",13,10
2671,NSGRN,246,62,184,16,230,S12000034,S99999999,S99999999,00QB,"Below 1,000 (b)",13,10
2672,NSGRO,102,48,54,13,89,S12000013,S99999999,S99999999,00RJ,"Below 1,000 (b)",13,10
2673,NSGRV,84,50,34,40,44,S12000017,S99999999,S99999999,00QT,"Below 1,000 (a)",12,10
2674,NSGSL,205,53,152,5,200,S12000017,S99999999,S99999999,00QT,"Below 1,000 (b)",13,10
2675,NSGTN,706,475,231,233,473,S12000034,S99999999,S99999999,00QB,"Below 1,000 (b)",13,10
2676,NSGTY,165,47,118,26,139,S12000034,S99999999,S99999999,00QB,"Below 1,000 (b)",13,10
2677,NSGUT,124,18,106,0,124,S12000027,S99999999,S99999999,00RD,"Below 1,000 (b)",13,10
2678,NSGVR,231,15,216,0,231,S12000013,S99999999,S99999999,00RJ,"Below 1,000 (b)",13,10
2679,NSHAM,495,246,249,165,330,S12000027,S99999999,S99999999,00RD,"Below 1,000 (b)",13,10
2680,NSHAT,646,501,145,420,226,S12000034,S99999999,S99999999,00QB,"Below 1,000 (b)",13,10
2681,NSHEL,539,419,120,334,205,S12000017,S99999999,S99999999,00QT,"Below 1,000 (b)",13,10
2682,NSHIL,183,78,105,59,124,S12000027,S99999999,S99999999,00RD,"Below 1,000 (b)",13,10
2683,NSHLD,62,0,62,0,62,S12000017,S99999999,S99999999,00QT,"Below 1,000 (b)",13,10
2684,NSHLK,695,586,109,497,198,S12000017,S99999999,S99999999,00QT,"Below 1,000 (b)",13,10
2685,NSHOL,383,224,159,163,220,S12000023,S99999999,S99999999,00RA,"Below 1,000 (a)",12,10
2686,NSHOP,2158,922,1236,758,1400,S12000020,S99999999,S99999999,00QX,"Above 1,000 (b)",11,10
2687,NSHOY,141,43,98,25,116,S12000023,S99999999,S99999999,00RA,"Below 1,000 (b)",13,10
2688,NSHRS,380,252,128,154,226,S12000013,S99999999,S99999999,00RJ,"Below 1,000 (b)",13,10
2689,NSHRY,441,204,237,114,327,S12000023,S99999999,S99999999,00RA,"Below 1,000 (b)",13,10
2690,NSHUN,2653,2560,93,2397,256,S12000034,S99999999,S99999999,00QB,"Above 1,000 (b)",11,10
2691,NSICL,6803,5001,1802,2736,4067,S12000017,S99999999,S99999999,00QT,"Above 3,000 (b)",9,10
2692,NSIGD,2264,2084,180,1788,476,S12000017,S99999999,S99999999,00QT,"Above 1,000 (a)",10,10
2693,NSIGR,210,71,139,51,159,S12000017,S99999999,S99999999,00QT,"Below 1,000 (b)",13,10
2694,NSIMD,24227,13493,10734,6029,18198,S12000017,S99999999,S99999999,00QT,"Above 20,000 (a)",4,30
2695,NSINS,1685,1330,355,1211,474,S12000034,S99999999,S99999999,00QB,"Above 1,000 (b)",11,10
2696,NSISL,274,120,154,95,179,S12000017,S99999999,S99999999,00QT,"Below 1,000 (b)",13,10
2697,NSIUR,6997,6408,589,3277,3720,S12000034,S99999999,S99999999,00QB,"Above 3,000 (a)",8,30
2698,NSIVA,1201,678,523,218,983,S12000034,S99999999,S99999999,00QB,"Above 1,000 (b)",11,10
2699,NSIVS,150,40,110,0,150,S12000017,S99999999,S99999999,00QT,"Below 1,000 (b)",13,10
2700,NSJOG,328,147,181,84,244,S12000017,S99999999,S99999999,00QT,"Below 1,000 (b)",13,10
2701,NSKBC,56,38,18,0,56,S12000017,S99999999,S99999999,00QT,"Below 1,000 (b)",13,10
2702,NSKCG,338,130,208,122,216,S12000017,S99999999,S99999999,00QT,"Below 1,000 (a)",12,10
2703,NSKCN,241,29,212,6,235,S12000017,S99999999,S99999999,00QT,"Below 1,000 (b)",13,10
2704,NSKDM,260,32,228,14,246,S12000034,S99999999,S99999999,00QB,"Below 1,000 (b)",13,10
2705,NSKDY,698,436,262,89,609,S12000017,S99999999,S99999999,00QT,"Below 1,000 (b)",13,10
2706,NSKED,320,83,237,31,289,S12000034,S99999999,S99999999,00QB,"Below 1,000 (b)",13,10
2707,NSKEM,2098,1820,278,1485,613,S12000034,S99999999,S99999999,00QB,"Above 1,000 (b)",11,10
2708,NSKEN,368,145,223,72,296,S12000034,S99999999,S99999999,00QB,"Below 1,000 (b)",13,10
2709,NSKES,1401,1039,362,424,977,S12000017,S99999999,S99999999,00QT,"Above 1,000 (b)",11,10
2710,NSKGL,21,0,21,0,21,S12000017,S99999999,S99999999,00QT,"Below 1,000 (b)",13,10
2711,NSKGS,955,785,170,751,204,S12000017,S99999999,S99999999,00QT,"Below 1,000 (b)",13,10
2712,NSKGW,6555,4298,2257,1984,4571,S12000033,S99999999,S99999999,00QA,Small City,3,50
2713,NSKHS,26,0,26,0,26,S12000017,S99999999,S99999999,00QT,"Below 1,000 (b)",13,10
2714,NSKIR,4675,4291,384,3308,1367,S12000023,S99999999,S99999999,00RA,"Above 3,000 (a)",8,30
2715,NSKIS,105,7,98,1,104,S12000017,S99999999,S99999999,00QT,"Below 1,000 (a)",12,10
2716,NSKLB,321,151,170,151,170,S12000017,S99999999,S99999999,00QT,"Below 1,000 (b)",13,10
2717,NSKLL,180,0,180,0,180,S12000017,S99999999,S99999999,00QT,"Below 1,000 (b)",13,10
2718,NSKLN,73,55,18,55,18,S12000017,S99999999,S99999999,00QT,"Below 1,000 (b)",13,10
2719,NSKLV,564,516,48,462,102,S12000017,S99999999,S99999999,00QT,"Below 1,000 (b)",13,10
2720,NSKLW,83,12,71,6,77,S12000017,S99999999,S99999999,00QT,"Below 1,000 (b)",13,10
2721,NSKNC,13125,8887,4238,3283,9842,S12000033,S99999999,S99999999,00QA,Small City,3,50
2722,NSKNL,1628,1330,298,1122,506,S12000033,S99999999,S99999999,00QA,"Above 1,000 (b)",11,10
2723,NSKNO,178,74,104,24,154,S12000034,S99999999,S99999999,00QB,"Below 1,000 (b)",13,10
2724,NSKON,327,190,137,148,179,S12000034,S99999999,S99999999,00QB,"Below 1,000 (b)",13,10
2725,NSKSS,307,165,142,135,172,S12000017,S99999999,S99999999,00QT,"Below 1,000 (b)",13,10
2726,NSKTH,2995,2687,308,2255,740,S12000020,S99999999,S99999999,00QX,"Above 1,000 (a)",10,10
2727,NSKTR,2366,2002,364,1452,914,S12000034,S99999999,S99999999,00QB,"Above 1,000 (b)",11,10
2728,NSKTY,794,434,360,270,524,S12000017,S99999999,S99999999,00QT,"Below 1,000 (b)",13,10
2729,NSKYL,717,603,114,393,324,S12000017,S99999999,S99999999,00QT,"Below 1,000 (a)",12,10
2730,NSLAG,165,0,165,0,165,S12000017,S99999999,S99999999,00QT,"Below 1,000 (b)",13,10
2731,NSLAI,542,333,209,288,254,S12000017,S99999999,S99999999,00QT,"Below 1,000 (b)",13,10
2732,NSLAT,166,89,77,84,82,S12000017,S99999999,S99999999,00QT,"Below 1,000 (b)",13,10
2733,NSLBD,489,171,318,116,373,S12000013,S99999999,S99999999,00RJ,"Below 1,000 (b)",13,10
2734,NSLBM,121,12,109,0,121,S12000017,S99999999,S99999999,00QT,"Below 1,000 (b)",13,10
2735,NSLCN,473,363,110,114,359,S12000017,S99999999,S99999999,00QT,"Below 1,000 (b)",13,10
2736,NSLER,3898,3061,837,1685,2213,S12000027,S99999999,S99999999,00RD,"Above 3,000 (a)",8,30
2737,NSLEV,208,154,54,79,129,S12000013,S99999999,S99999999,00RJ,"Below 1,000 (b)",13,10
2738,NSLHA,1419,1100,319,974,445,S12000020,S99999999,S99999999,00QX,"Above 1,000 (b)",11,10
2739,NSLHP,186,105,81,72,114,S12000023,S99999999,S99999999,00RA,"Below 1,000 (b)",13,10
2740,NSLLT,116,0,116,0,116,S12000017,S99999999,S99999999,00QT,"Below 1,000 (b)",13,10
2741,NSLMD,194,135,59,117,77,S12000013,S99999999,S99999999,00RJ,"Below 1,000 (a)",12,10
2742,NSLMN,452,216,236,44,408,S12000020,S99999999,S99999999,00QX,"Below 1,000 (b)",13,10
2743,NSLMR,68,0,68,0,68,S12000017,S99999999,S99999999,00QT,"Below 1,000 (b)",13,10
2744,NSLMY,692,433,259,376,316,S12000034,S99999999,S99999999,00QB,"Below 1,000 (b)",13,10
2745,NSLNG,10430,10217,213,7416,3014,S12000033,S99999999,S99999999,00QA,Small City,3,50
2746,NSLOS,3515,3398,117,2325,1190,S12000020,S99999999,S99999999,00QX,"Above 3,000 (b)",9,10
2747,NSLPT,265,59,206,0,265,S12000013,S99999999,S99999999,00RJ,"Below 1,000 (b)",13,10
2748,NSLSD,811,535,276,487,324,S12000034,S99999999,S99999999,00QB,"Below 1,000 (b)",13,10
2749,NSLSV,152,79,73,0,152,S12000017,S99999999,S99999999,00QT,"Below 1,000 (b)",13,10
2750,NSLUM,500,318,182,252,248,S12000034,S99999999,S99999999,00QB,"Below 1,000 (a)",12,10
2751,NSLVR,416,264,152,224,192,S12000017,S99999999,S99999999,00QT,"Below 1,000 (b)",13,10
2752,NSLYB,552,383,169,240,312,S12000017,S99999999,S99999999,00QT,"Below 1,000 (a)",12,10
2753,NSLYT,171,28,143,9,162,S12000017,S99999999,S99999999,00QT,"Below 1,000 (b)",13,10
2754,NSMAL,652,436,216,125,527,S12000017,S99999999,S99999999,00QT,"Below 1,000 (b)",13,10
2755,NSMAN,168,44,124,9,159,S12000013,S99999999,S99999999,00RJ,"Below 1,000 (b)",13,10
2756,NSMAU,598,474,124,428,170,S12000034,S99999999,S99999999,00QB,"Below 1,000 (a)",12,10
2757,NSMDF,2129,2049,80,1893,236,S12000034,S99999999,S99999999,00QB,"Above 1,000 (a)",10,10
2758,NSMEL,204,168,36,0,204,S12000017,S99999999,S99999999,00QT,"Below 1,000 (b)",13,10
2759,NSMEM,410,185,225,114,296,S12000034,S99999999,S99999999,00QB,"Below 1,000 (b)",13,10
2760,NSMER,34,9,25,9,25,S12000017,S99999999,S99999999,00QT,"Below 1,000 (b)",13,10
2761,NSMET,665,344,321,282,383,S12000034,S99999999,S99999999,00QB,"Below 1,000 (a)",12,10
2762,NSMID,196,123,73,75,121,S12000027,S99999999,S99999999,00RD,"Below 1,000 (b)",13,10
2763,NSMIN,2368,1418,950,1262,1106,S12000034,S99999999,S99999999,00QB,"Above 1,000 (a)",10,10
2764,NSMOF,346,118,228,39,307,S12000034,S99999999,S99999999,00QB,"Below 1,000 (b)",13,10
2765,NSMON,477,239,238,205,272,S12000034,S99999999,S99999999,00QB,"Below 1,000 (b)",13,10
2766,NSMOO,1730,1421,309,979,751,S12000017,S99999999,S99999999,00QT,"Above 1,000 (b)",11,10
2767,NSMOR,213,114,99,71,142,S12000017,S99999999,S99999999,00QT,"Below 1,000 (a)",12,10
2768,NSMUL,193,87,106,46,147,S12000020,S99999999,S99999999,00QX,"Below 1,000 (b)",13,10
2769,NSMUN,678,261,417,232,446,S12000017,S99999999,S99999999,00QT,"Below 1,000 (b)",13,10
2770,NSNAB,376,185,191,146,230,S12000034,S99999999,S99999999,00QB,"Below 1,000 (b)",13,10
2771,NSNAI,5579,4716,863,2766,2813,S12000017,S99999999,S99999999,00QT,"Above 3,000 (a)",8,30
2772,NSNBR,987,724,263,631,356,S12000034,S99999999,S99999999,00QB,"Below 1,000 (b)",13,10
2773,NSNBY,357,67,290,15,342,S12000013,S99999999,S99999999,00RJ,"Below 1,000 (b)",13,10
2774,NSNDR,711,443,268,355,356,S12000034,S99999999,S99999999,00QB,"Below 1,000 (b)",13,10
2775,NSNER,144,21,123,21,123,S12000017,S99999999,S99999999,00QT,"Below 1,000 (b)",13,10
2776,NSNET,537,443,94,180,357,S12000017,S99999999,S99999999,00QT,"Below 1,000 (b)",13,10
2777,NSNHL,1932,1601,331,823,1109,S12000034,S99999999,S99999999,00QB,"Above 1,000 (b)",11,10
2778,NSNIG,113,57,56,21,92,S12000017,S99999999,S99999999,00QT,"Below 1,000 (a)",12,10
2779,NSNMC,1796,1346,450,1072,724,S12000034,S99999999,S99999999,00QB,"Above 1,000 (b)",11,10
2780,NSNMR,702,626,76,582,120,S12000017,S99999999,S99999999,00QT,"Below 1,000 (a)",12,10
2781,NSNPT,732,558,174,449,283,S12000034,S99999999,S99999999,00QB,"Below 1,000 (b)",13,10
2782,NSNRE,82,62,20,62,20,S12000027,S99999999,S99999999,00RD,"Below 1,000 (a)",12,10
2783,NSNRS,51,27,24,27,24,S12000023,S99999999,S99999999,00RA,"Below 1,000 (b)",13,10
2784,NSNST,149,104,45,34,115,S12000017,S99999999,S99999999,00QT,"Below 1,000 (b)",13,10
2785,NSNTH,13707,13629,78,7292,6415,S12000033,S99999999,S99999999,00QA,Small City,3,50
2786,NSNTT,241,210,31,147,94,S12000013,S99999999,S99999999,00RJ,"Below 1,000 (b)",13,10
2787,NSOLL,133,50,83,50,83,S12000027,S99999999,S99999999,00RD,"Below 1,000 (b)",13,10
2788,NSOMD,1687,1479,208,1391,296,S12000034,S99999999,S99999999,00QB,"Above 1,000 (a)",10,10
2789,NSONI,274,71,203,0,274,S12000017,S99999999,S99999999,00QT,"Below 1,000 (b)",13,10
2790,NSORN,473,194,279,132,341,S12000034,S99999999,S99999999,00QB,"Below 1,000 (b)",13,10
2791,NSORP,323,101,222,101,222,S12000023,S99999999,S99999999,00RA,"Below 1,000 (b)",13,10
2792,NSORT,89,55,34,23,66,S12000020,S99999999,S99999999,00QX,"Below 1,000 (b)",13,10
2793,NSOUT,45,45,0,20,25,S12000027,S99999999,S99999999,00RD,"Below 1,000 (a)",12,10
2794,NSPET,10396,7762,2634,3727,6669,S12000034,S99999999,S99999999,00QB,"Above 10,000 (b)",7,30
2795,NSPIT,503,251,252,135,368,S12000034,S99999999,S99999999,00QB,"Below 1,000 (b)",13,10
2796,NSPLO,294,212,82,104,190,S12000017,S99999999,S99999999,00QT,"Below 1,000 (b)",13,10
2797,NSPMH,551,52,499,18,533,S12000017,S99999999,S99999999,00QT,"Below 1,000 (b)",13,10
2798,NSPON,713,416,297,141,572,S12000013,S99999999,S99999999,00RJ,"Below 1,000 (a)",12,10
2799,NSPOO,189,152,37,78,111,S12000017,S99999999,S99999999,00QT,"Below 1,000 (b)",13,10
2800,NSPOY,326,89,237,17,309,S12000017,S99999999,S99999999,00QT,"Below 1,000 (b)",13,10
2801,NSPPS,15,15,0,0,15,S12000027,S99999999,S99999999,00RD,"Below 1,000 (b)",13,10
2802,NSPPW,62,62,0,62,0,S12000023,S99999999,S99999999,00RA,"Below 1,000 (a)",12,10
2803,NSPRT,4495,3564,931,1637,2858,S12000033,S99999999,S99999999,00QA,"Above 3,000 (b)",9,10
2804,NSPSY,1269,975,294,942,327,S12000034,S99999999,S99999999,00QB,"Above 1,000 (a)",10,10
2805,NSPTR,1589,1431,158,1177,412,S12000017,S99999999,S99999999,00QT,"Above 1,000 (b)",11,10
2806,NSRAA,162,139,23,25,137,S12000017,S99999999,S99999999,00QT,"Below 1,000 (a)",12,10
2807,NSREY,232,119,113,41,191,S12000017,S99999999,S99999999,00QT,"Below 1,000 (b)",13,10
2808,NSRHL,199,20,179,0,199,S12000017,S99999999,S99999999,00QT,"Below 1,000 (b)",13,10
2809,NSRHT,962,646,316,614,348,S12000034,S99999999,S99999999,00QB,"Below 1,000 (b)",13,10
2810,NSRHY,384,242,142,207,177,S12000034,S99999999,S99999999,00QB,"Below 1,000 (a)",12,10
2811,NSRMY,240,95,145,60,180,S12000034,S99999999,S99999999,00QB,"Below 1,000 (b)",13,10
2812,NSRNM,670,536,134,458,212,S12000034,S99999999,S99999999,00QB,"Below 1,000 (b)",13,10
2813,NSROG,330,130,200,68,262,S12000017,S99999999,S99999999,00QT,"Below 1,000 (b)",13,10
2814,NSROU,236,33,203,33,203,S12000023,S99999999,S99999999,00RA,"Below 1,000 (b)",13,10
2815,NSRTS,763,663,100,638,125,S12000020,S99999999,S99999999,00QX,"Below 1,000 (a)",12,10
2816,NSRWK,139,53,86,39,100,S12000027,S99999999,S99999999,00RD,"Below 1,000 (b)",13,10
2817,NSSAL,379,116,263,88,291,S12000017,S99999999,S99999999,00QT,"Below 1,000 (b)",13,10
2818,NSSAU,641,275,366,209,432,S12000034,S99999999,S99999999,00QB,"Below 1,000 (b)",13,10
2819,NSSBY,722,523,199,293,429,S12000020,S99999999,S99999999,00QX,"Below 1,000 (b)",13,10
2820,NSSCH,349,141,208,30,319,S12000034,S99999999,S99999999,00QB,"Below 1,000 (b)",13,10
2821,NSSCN,71,0,71,0,71,S12000017,S99999999,S99999999,00QT,"Below 1,000 (b)",13,10
2822,NSSCO,151,85,66,46,105,S12000017,S99999999,S99999999,00QT,"Below 1,000 (b)",13,10
2823,NSSCP,89,0,89,0,89,S12000013,S99999999,S99999999,00RJ,"Below 1,000 (b)",13,10
2824,NSSDN,298,105,193,55,243,S12000034,S99999999,S99999999,00QB,"Below 1,000 (b)",13,10
2825,NSSDS,127,85,42,0,127,S12000027,S99999999,S99999999,00RD,"Below 1,000 (b)",13,10
2826,NSSDY,287,91,196,25,262,S12000023,S99999999,S99999999,00RA,"Below 1,000 (b)",13,10
2827,NSSFR,135,65,70,28,107,S12000017,S99999999,S99999999,00QT,"Below 1,000 (b)",13,10
2828,NSSHA,447,186,261,122,325,S12000013,S99999999,S99999999,00RJ,"Below 1,000 (a)",12,10
2829,NSSHI,143,105,38,92,51,S12000017,S99999999,S99999999,00QT,"Below 1,000 (b)",13,10
2830,NSSKB,411,65,346,17,394,S12000017,S99999999,S99999999,00QT,"Below 1,000 (b)",13,10
2831,NSSKD,79,15,64,0,79,S12000017,S99999999,S99999999,00QT,"Below 1,000 (b)",13,10
2832,NSSKL,219,22,197,0,219,S12000027,S99999999,S99999999,00RD,"Below 1,000 (b)",13,10
2833,NSSLI,181,19,162,0,181,S12000017,S99999999,S99999999,00QT,"Below 1,000 (b)",13,10
2834,NSSLW,889,645,244,551,338,S12000027,S99999999,S99999999,00RD,"Below 1,000 (a)",12,10
2835,NSSNS,1559,1204,355,1013,546,S12000023,S99999999,S99999999,00RA,"Above 1,000 (a)",10,10
2836,NSSNV,41,38,3,0,41,S12000017,S99999999,S99999999,00QT,"Below 1,000 (b)",13,10
2837,NSSOL,159,50,109,31,128,S12000013,S99999999,S99999999,00RJ,"Below 1,000 (b)",13,10
2838,NSSOR,265,83,182,9,256,S12000023,S99999999,S99999999,00RA,"Below 1,000 (b)",13,10
2839,NSSPB,723,259,464,178,545,S12000017,S99999999,S99999999,00QT,"Below 1,000 (b)",13,10
2840,NSSPF,999,583,416,475,524,S12000017,S99999999,S99999999,00QT,"Below 1,000 (b)",13,10
2841,NSSPY,254,150,104,100,154,S12000013,S99999999,S99999999,00RJ,"Below 1,000 (b)",13,10
2842,NSSSH,398,335,63,240,158,S12000027,S99999999,S99999999,00RD,"Below 1,000 (a)",12,10
2843,NSSST,110,32,78,0,110,S12000013,S99999999,S99999999,00RJ,"Below 1,000 (b)",13,10
2844,NSSSY,195,16,179,16,179,S12000023,S99999999,S99999999,00RA,"Below 1,000 (a)",12,10
2845,NSSTA,301,160,141,55,246,S12000017,S99999999,S99999999,00QT,"Below 1,000 (b)",13,10
2846,NSSTE,192,59,133,47,145,S12000017,S99999999,S99999999,00QT,"Below 1,000 (b)",13,10
2847,NSSTF,511,338,173,29,482,S12000034,S99999999,S99999999,00QB,"Below 1,000 (b)",13,10
2848,NSSTH,100,59,41,47,53,S12000017,S99999999,S99999999,00QT,"Below 1,000 (a)",12,10
2849,NSSTM,507,275,232,212,295,S12000023,S99999999,S99999999,00RA,"Below 1,000 (a)",12,10
2850,NSSTN,264,124,140,124,140,S12000017,S99999999,S99999999,00QT,"Below 1,000 (b)",13,10
2851,NSSTR,778,583,195,515,263,S12000034,S99999999,S99999999,00QB,"Below 1,000 (b)",13,10
2852,NSSTU,104,21,83,21,83,S12000017,S99999999,S99999999,00QT,"Below 1,000 (b)",13,10
2853,NSSUL,172,16,156,0,172,S12000027,S99999999,S99999999,00RD,"Below 1,000 (b)",13,10
2854,NSSUM,562,137,425,88,474,S12000027,S99999999,S99999999,00RD,"Below 1,000 (b)",13,10
2855,NSSUN,281,46,235,30,251,S12000017,S99999999,S99999999,00QT,"Below 1,000 (b)",13,10
2856,NSSVN,5573,5350,223,3369,2204,S12000034,S99999999,S99999999,00QB,"Above 3,000 (a)",8,30
2857,NSSWL,107,0,107,0,107,S12000017,S99999999,S99999999,00QT,"Below 1,000 (b)",13,10
2858,NSSWY,4652,3487,1165,2150,2502,S12000013,S99999999,S99999999,00RJ,"Above 3,000 (a)",8,30
2859,NSSYM,453,280,173,129,324,S12000027,S99999999,S99999999,00RD,"Below 1,000 (a)",12,10
2860,NSTAI,2121,1946,175,1854,267,S12000017,S99999999,S99999999,00QT,"Above 1,000 (a)",10,10
2861,NSTAL,172,79,93,38,134,S12000017,S99999999,S99999999,00QT,"Below 1,000 (b)",13,10
2862,NSTAN,224,119,105,29,195,S12000023,S99999999,S99999999,00RA,"Below 1,000 (b)",13,10
2863,NSTCR,32,0,32,0,32,S12000017,S99999999,S99999999,00QT,"Below 1,000 (b)",13,10
2864,NSTDN,63,0,63,0,63,S12000017,S99999999,S99999999,00QT,"Below 1,000 (b)",13,10
2865,NSTHR,218,151,67,82,136,S12000017,S99999999,S99999999,00QT,"Below 1,000 (b)",13,10
2866,NSTHU,4478,4212,266,3134,1344,S12000017,S99999999,S99999999,00QT,"Above 3,000 (a)",8,30
2867,NSTIM,302,32,270,14,288,S12000013,S99999999,S99999999,00RJ,"Below 1,000 (b)",13,10
2868,NSTKV,74,60,14,0,74,S12000017,S99999999,S99999999,00QT,"Below 1,000 (b)",13,10
2869,NSTLD,795,429,366,364,431,S12000034,S99999999,S99999999,00QB,"Below 1,000 (b)",13,10
2870,NSTON,171,91,80,80,91,S12000017,S99999999,S99999999,00QT,"Below 1,000 (b)",13,10
2871,NSTPH,819,643,176,542,277,S12000034,S99999999,S99999999,00QB,"Below 1,000 (b)",13,10
2872,NSTRD,129,52,77,9,120,S12000017,S99999999,S99999999,00QT,"Below 1,000 (b)",13,10
2873,NSTTL,437,244,193,233,204,S12000034,S99999999,S99999999,00QB,"Below 1,000 (b)",13,10
2874,NSTTN,215,99,116,92,123,S12000017,S99999999,S99999999,00QT,"Below 1,000 (b)",13,10
2875,NSTUL,88,0,88,0,88,S12000017,S99999999,S99999999,00QT,"Below 1,000 (b)",13,10
2876,NSTUR,3018,2714,304,2105,913,S12000034,S99999999,S99999999,00QB,"Above 3,000 (a)",8,30
2877,NSTVS,798,584,214,520,278,S12000034,S99999999,S99999999,00QB,"Below 1,000 (a)",12,10
2878,NSUDN,1157,724,433,35,1122,S12000034,S99999999,S99999999,00QB,"Above 1,000 (b)",11,10
2879,NSUIG,286,158,128,70,216,S12000017,S99999999,S99999999,00QT,"Below 1,000 (b)",13,10
2880,NSULL,977,786,191,720,257,S12000017,S99999999,S99999999,00QT,"Below 1,000 (b)",13,10
2881,NSURR,311,119,192,89,222,S12000017,S99999999,S99999999,00QT,"Below 1,000 (b)",13,10
2882,NSUYE,107,35,72,35,72,S12000027,S99999999,S99999999,00RD,"Below 1,000 (b)",13,10
2883,NSVID,151,92,59,17,134,S12000027,S99999999,S99999999,00RD,"Below 1,000 (b)",13,10
2884,NSVOE,232,65,167,0,232,S12000027,S99999999,S99999999,00RD,"Below 1,000 (b)",13,10
2885,NSWAL,229,121,108,86,143,S12000027,S99999999,S99999999,00RD,"Below 1,000 (b)",13,10
2886,NSWAR,581,256,325,20,561,S12000034,S99999999,S99999999,00QB,"Below 1,000 (b)",13,10
2887,NSWDL,152,12,140,12,140,S12000017,S99999999,S99999999,00QT,"Below 1,000 (b)",13,10
2888,NSWEI,312,168,144,111,201,S12000027,S99999999,S99999999,00RD,"Below 1,000 (b)",13,10
2889,NSWES,12170,12141,29,5525,6645,S12000033,S99999999,S99999999,00QA,Small City,3,50
2890,NSWFC,198,31,167,9,189,S12000017,S99999999,S99999999,00QT,"Below 1,000 (b)",13,10
2891,NSWHL,842,775,67,595,247,S12000034,S99999999,S99999999,00QB,"Below 1,000 (b)",13,10
2892,NSWIC,4317,3817,500,2969,1348,S12000017,S99999999,S99999999,00QT,"Above 3,000 (a)",8,30
2893,NSWNS,223,26,197,20,203,S12000017,S99999999,S99999999,00QT,"Below 1,000 (a)",12,10
2894,NSWRS,274,134,140,39,235,S12000034,S99999999,S99999999,00QB,"Below 1,000 (b)",13,10
2895,NSWRY,359,39,320,23,336,S12000023,S99999999,S99999999,00RA,"Below 1,000 (b)",13,10
2896,NSWSW,74,34,40,0,74,S12000027,S99999999,S99999999,00RD,"Below 1,000 (b)",13,10
2897,NSWTT,351,160,191,135,216,S12000017,S99999999,S99999999,00QT,"Below 1,000 (b)",13,10
2898,NSYTH,186,74,112,21,165,S12000034,S99999999,S99999999,00QB,"Below 1,000 (b)",13,10
2899,SDBGNRR,19370,14387,4983,5551,13819,E07000224,E10000032,E12000008,45,"Above 10,000 (a)",6,30
2900,SDBLCMB,871,725,146,600,271,E07000228,E10000032,E12000008,45,"Below 1,000 (b)",13,10
2901,SDBLLNG,4071,3804,267,2648,1423,E07000227,E10000032,E12000008,45,"Above 3,000 (b)",9,10
2902,SDBLNY,838,495,343,330,508,E07000228,E10000032,E12000008,45,"Below 1,000 (b)",13,10
2903,SDBMBRD,4468,2970,1498,1595,2873,E06000046,E99999999,E12000008,00MW,"Above 3,000 (b)",9,10
2904,SDBRCKL,4313,3586,727,2087,2226,E07000225,E10000032,E12000008,45,"Above 3,000 (b)",9,10
2905,SDBRCMB,932,601,331,416,516,E07000063,E10000011,E12000008,21,"Below 1,000 (b)",13,10
2906,SDBRDHM,1442,962,480,410,1032,E07000225,E10000032,E12000008,45,"Above 1,000 (b)",11,10
2907,SDBRGHS,1107,741,366,632,475,E06000046,E99999999,E12000008,00MW,"Above 1,000 (b)",11,10
2908,SDBRGSS,14063,13613,450,5813,8250,E07000063,E10000011,E12000008,21,"Above 10,000 (b)",7,30
2909,SDBRY,872,444,428,204,668,E07000227,E10000032,E12000008,45,"Below 1,000 (b)",13,10
2910,SDBSHM,3672,1785,1887,1152,2520,E07000225,E10000032,E12000008,45,"Above 3,000 (b)",9,10
2911,SDCHCHS,19464,15161,4303,6522,12942,E07000225,E10000032,E12000008,45,"Above 10,000 (b)",7,30
2912,SDCHLGR,415,283,132,182,233,E06000046,E99999999,E12000008,00MW,"Below 1,000 (b)",13,10
2913,SDCHLLR,703,494,209,133,570,E06000046,E99999999,E12000008,00MW,"Below 1,000 (b)",13,10
2914,SDCLBRN,782,236,546,109,673,E06000046,E99999999,E12000008,00MW,"Below 1,000 (b)",13,10
2915,SDCLHM,788,280,508,121,667,E07000227,E10000032,E12000008,45,"Below 1,000 (b)",13,10
2916,SDCMPTN,390,207,183,81,309,E07000225,E10000032,E12000008,45,"Below 1,000 (b)",13,10
2917,SDCRWLY,31561,19448,12113,6037,25524,E07000227,E10000032,E12000008,45,"Above 20,000 (b)",5,30
2918,SDCSHM,23774,14421,9353,5782,17992,E07000094,E10000014,E12000008,24,"Above 20,000 (b)",5,30
2919,SDCWFLD,929,744,185,597,332,E07000228,E10000032,E12000008,45,"Below 1,000 (b)",13,10
2920,SDCWS,12024,10179,1845,6110,5914,E06000046,E99999999,E12000008,00MW,"Above 10,000 (b)",7,30
2921,SDESTBR,22995,21643,1352,8291,14704,E07000061,E10000011,E12000008,21,"Above 20,000 (a)",4,30
2922,SDFNDN,2340,2249,91,1134,1206,E07000227,E10000032,E12000008,45,"Above 1,000 (b)",11,10
2923,SDFRHM,18427,11156,7271,5094,13333,E07000094,E10000014,E12000008,24,"Above 10,000 (b)",7,30
2924,SDFRSHW,4766,4660,106,3032,1734,E06000046,E99999999,E12000008,00MW,"Above 3,000 (a)",8,30
2925,SDFTTLW,831,489,342,324,507,E07000227,E10000032,E12000008,45,"Below 1,000 (b)",13,10
2926,SDFYGT,4401,773,3628,282,4119,E07000227,E10000032,E12000008,45,"Above 3,000 (b)",9,10
2927,SDGDSHL,1222,658,564,523,699,E06000046,E99999999,E12000008,00MW,"Above 1,000 (b)",11,10
2928,SDGLYND,396,285,111,138,258,E07000063,E10000011,E12000008,21,"Below 1,000 (b)",13,10
2929,SDGRFFH,500,311,189,191,309,E07000225,E10000032,E12000008,45,"Below 1,000 (b)",13,10
2930,SDGSPRT,22087,18067,4020,7131,14956,E07000088,E10000014,E12000008,24,Small City,3,50
2931,SDHLSHM,11155,10061,1094,4914,6241,E07000065,E10000011,E12000008,21,"Above 10,000 (b)",7,30
2932,SDHMBLD,2121,483,1638,355,1766,E07000085,E10000014,E12000008,24,"Above 1,000 (b)",11,10
2933,SDHMPDN,11908,11232,676,3547,8361,E07000065,E10000011,E12000008,21,"Above 10,000 (a)",6,30
2934,SDHNDCR,1307,688,619,480,827,E07000228,E10000032,E12000008,45,"Above 1,000 (b)",11,10
2935,SDHNFLD,3302,2577,725,2021,1281,E07000228,E10000032,E12000008,45,"Above 3,000 (b)",9,10
2936,SDHRLY,12026,10993,1033,5590,6436,E07000211,E10000030,E12000008,43,"Above 10,000 (b)",7,30
2937,SDHRNDN,12358,7461,4897,2645,9713,E07000085,E10000014,E12000008,24,"Above 10,000 (b)",7,30
2938,SDHRSHM,23491,17251,6240,6583,16908,E07000227,E10000032,E12000008,45,"Above 20,000 (a)",4,30
2939,SDHRSTM,1605,1114,491,588,1017,E07000065,E10000011,E12000008,21,"Above 1,000 (b)",11,10
2940,SDHRSTP,3332,3035,297,2037,1295,E07000228,E10000032,E12000008,45,"Above 3,000 (b)",9,10
2941,SDHRTNG,688,528,160,398,290,E07000225,E10000032,E12000008,45,"Below 1,000 (b)",13,10
2942,SDHSSCK,4418,4025,393,2912,1506,E06000043,E99999999,E12000008,00ML,"Above 3,000 (b)",9,10
2943,SDHV,26026,26026,0,14249,11777,E06000043,E99999999,E12000008,00ML,Small City,3,50
2944,SDHVNT,19634,15229,4405,5318,14316,E06000044,E99999999,E12000008,00MR,Small City,3,50
2945,SDHWKLY,436,170,266,19,417,E07000085,E10000014,E12000008,24,"Below 1,000 (b)",13,10
2946,SDHYLNG,9032,5914,3118,3509,5523,E06000044,E99999999,E12000008,00MR,Small City,3,50
2947,SDHYWRD,13912,11541,2371,5076,8836,E07000063,E10000011,E12000008,21,"Above 10,000 (b)",7,30
2948,SDKMPTW,36488,30911,5577,13539,22949,E06000043,E99999999,E12000008,00ML,Small City,3,50
2949,SDKRDFR,521,395,126,297,224,E07000225,E10000032,E12000008,45,"Below 1,000 (b)",13,10
2950,SDLDSWR,573,294,279,193,380,E07000225,E10000032,E12000008,45,"Below 1,000 (b)",13,10
2951,SDLFRST,873,564,309,462,411,E07000065,E10000011,E12000008,21,"Below 1,000 (b)",13,10
2952,SDLNCNG,13143,12875,268,6798,6345,E07000229,E10000032,E12000008,45,"Above 10,000 (a)",6,30
2953,SDLNDFL,4359,4324,35,2762,1597,E07000228,E10000032,E12000008,45,"Above 3,000 (b)",9,10
2954,SDLSLNT,12420,6534,5886,4442,7978,E07000087,E10000014,E12000008,24,Small City,3,50
2955,SDLSS,2967,2645,322,1747,1220,E07000225,E10000032,E12000008,45,"Above 1,000 (b)",11,10
2956,SDLTTLH,16725,15910,815,6747,9978,E07000224,E10000032,E12000008,45,"Above 10,000 (a)",6,30
2957,SDLWRBD,1004,407,597,88,916,E07000227,E10000032,E12000008,45,"Above 1,000 (b)",11,10
2958,SDLWS,8770,8084,686,4976,3794,E07000063,E10000011,E12000008,21,"Above 3,000 (a)",8,30
2959,SDLXWD,1354,970,384,428,926,E07000227,E10000032,E12000008,45,"Above 1,000 (b)",11,10
2960,SDMDDLT,5910,5654,256,2861,3049,E07000224,E10000032,E12000008,45,"Above 3,000 (b)",9,10
2961,SDMDHRS,4612,3774,838,2516,2096,E07000225,E10000032,E12000008,45,"Above 3,000 (b)",9,10
2962,SDMSWRT,9412,5610,3802,3082,6330,E07000225,E10000032,E12000008,45,"Above 3,000 (a)",8,30
2963,SDNRWDH,910,266,644,24,886,E07000211,E10000030,E12000008,43,"Below 1,000 (b)",13,10
2964,SDNTN,1381,1073,308,605,776,E06000046,E99999999,E12000008,00MW,"Above 1,000 (b)",11,10
2965,SDNWHVN,6747,6270,477,3860,2887,E07000063,E10000011,E12000008,21,"Above 3,000 (b)",9,10
2966,SDNWPRT,11941,11183,758,6276,5665,E06000046,E99999999,E12000008,00MW,"Above 10,000 (a)",6,30
2967,SDPCHVN,9494,9023,471,4652,4842,E06000043,E99999999,E12000008,00ML,Small City,3,50
2968,SDPCNTC,37051,24604,12447,8877,28174,E06000044,E99999999,E12000008,00MR,Small City,3,50
2969,SDPGHM,7701,6405,1296,3262,4439,E07000224,E10000032,E12000008,45,"Above 3,000 (b)",9,10
2970,SDPLBRG,3253,2334,919,1773,1480,E07000227,E10000032,E12000008,45,"Above 3,000 (a)",8,30
2971,SDPLGT,6631,6406,225,3972,2659,E07000065,E10000011,E12000008,21,"Above 3,000 (a)",8,30
2972,SDPLMPT,1417,731,686,470,947,E07000063,E10000011,E12000008,21,"Above 1,000 (b)",11,10
2973,SDPLSTW,468,301,167,149,319,E07000225,E10000032,E12000008,45,"Below 1,000 (b)",13,10
2974,SDPNDHL,11737,9267,2470,5040,6697,E07000228,E10000032,E12000008,45,"Above 10,000 (a)",6,30
2975,SDPNRTH,27852,24186,3666,12329,15523,E06000044,E99999999,E12000008,00MR,Small City,3,50
2976,SDPRTRD,1453,1203,250,917,536,E07000227,E10000032,E12000008,45,"Above 1,000 (b)",11,10
2977,SDPRTSL,19816,19037,779,8138,11678,E06000043,E99999999,E12000008,00ML,Small City,3,50
2978,SDPRVTT,363,182,181,52,311,E07000085,E10000014,E12000008,24,"Below 1,000 (b)",13,10
2979,SDPTCHN,484,332,152,221,263,E07000229,E10000032,E12000008,45,"Below 1,000 (b)",13,10
2980,SDPTRSF,8243,7312,931,4654,3589,E07000225,E10000032,E12000008,45,"Above 3,000 (b)",9,10
2981,SDPTWRT,1837,1651,186,1245,592,E07000225,E10000032,E12000008,45,"Above 1,000 (a)",10,10
2982,SDPVNSM,11925,11483,442,6483,5442,E07000065,E10000011,E12000008,21,"Above 10,000 (a)",6,30
2983,SDPVNSY,6760,3933,2827,1057,5703,E07000065,E10000011,E12000008,21,"Above 3,000 (b)",9,10
2984,SDPYNNG,509,273,236,137,372,E06000043,E99999999,E12000008,00ML,"Below 1,000 (b)",13,10
2985,SDRDGWC,1240,1020,220,722,518,E07000227,E10000032,E12000008,45,"Above 1,000 (a)",10,10
2986,SDRDNGL,807,744,63,559,248,E07000228,E10000032,E12000008,45,"Below 1,000 (b)",13,10
2987,SDRGT,703,424,279,246,457,E07000225,E10000032,E12000008,45,"Below 1,000 (b)",13,10
2988,SDRNDL,2555,2200,355,1848,707,E07000224,E10000032,E12000008,45,"Above 1,000 (b)",11,10
2989,SDRNGMR,2047,1555,492,1112,935,E07000063,E10000011,E12000008,21,"Above 1,000 (b)",11,10
2990,SDRP,442,200,242,84,358,E07000063,E10000011,E12000008,21,"Below 1,000 (b)",13,10
2991,SDRSPR,602,359,243,208,394,E07000227,E10000032,E12000008,45,"Below 1,000 (b)",13,10
2992,SDRSTNG,12071,11107,964,4496,7575,E07000224,E10000032,E12000008,45,"Above 10,000 (b)",7,30
2993,SDRTTNG,9020,5119,3901,1554,7466,E06000043,E99999999,E12000008,00ML,Small City,3,50
2994,SDRWLND,1717,1337,380,946,771,E07000225,E10000032,E12000008,45,"Above 1,000 (b)",11,10
2995,SDRYD,12963,11886,1077,5795,7168,E06000046,E99999999,E12000008,00MW,"Above 10,000 (a)",6,30
2996,SDSCYNS,988,765,223,404,584,E07000063,E10000011,E12000008,21,"Below 1,000 (b)",13,10
2997,SDSDLSH,682,531,151,269,413,E07000225,E10000032,E12000008,45,"Below 1,000 (b)",13,10
2998,SDSFRD,11367,10655,712,4957,6410,E07000063,E10000011,E12000008,21,"Above 10,000 (a)",6,30
2999,SDSHNGT,1686,1189,497,1014,672,E07000227,E10000032,E12000008,45,"Above 1,000 (b)",11,10
3000,SDSHNKL,6338,5626,712,4151,2187,E06000046,E99999999,E12000008,00MW,"Above 3,000 (b)",9,10
3001,SDSHRHM,8522,8471,51,4861,3661,E07000223,E10000032,E12000008,45,"Above 3,000 (b)",9,10
3002,SDSLNDN,797,522,275,212,585,E07000224,E10000032,E12000008,45,"Below 1,000 (b)",13,10
3003,SDSLNFL,2643,803,1840,553,2090,E07000227,E10000032,E12000008,45,"Above 1,000 (b)",11,10
3004,SDSLSY,5512,5434,78,3780,1732,E07000225,E10000032,E12000008,45,"Above 3,000 (a)",8,30
3005,SDSNDWN,7097,5774,1323,4021,3076,E06000046,E99999999,E12000008,00MW,"Above 3,000 (b)",9,10
3006,SDSNGLT,661,334,327,191,470,E07000225,E10000032,E12000008,45,"Below 1,000 (b)",13,10
3007,SDSTBBN,7865,6310,1555,4847,3018,E07000087,E10000014,E12000008,24,Small City,3,50
3008,SDSTDN,943,830,113,771,172,E07000065,E10000011,E12000008,21,"Below 1,000 (b)",13,10
3009,SDSTHWC,9008,8197,811,4305,4703,E06000043,E99999999,E12000008,00ML,Small City,3,50
3010,SDSTHWT,4779,3837,942,2961,1818,E07000227,E10000032,E12000008,45,"Above 3,000 (b)",9,10
3011,SDSTMN,674,387,287,322,352,E07000085,E10000014,E12000008,24,"Below 1,000 (b)",13,10
3012,SDSTMRD,214,64,150,27,187,E07000225,E10000032,E12000008,45,"Below 1,000 (b)",13,10
3013,SDSTRGT,5375,3460,1915,1315,4060,E07000224,E10000032,E12000008,45,"Above 3,000 (b)",9,10
3014,SDSTTN,321,177,144,107,214,E07000225,E10000032,E12000008,45,"Below 1,000 (b)",13,10
3015,SDSTYNN,4729,3981,748,2343,2386,E07000227,E10000032,E12000008,45,"Above 3,000 (b)",9,10
3016,SDTTCHF,8619,8074,545,2977,5642,E07000094,E10000014,E12000008,24,"Above 3,000 (b)",9,10
3017,SDVNTNR,4130,3372,758,2459,1671,E06000046,E99999999,E12000008,00MW,"Above 3,000 (b)",9,10
3018,SDWCKHM,3240,1500,1740,1011,2229,E07000094,E10000014,E12000008,24,"Above 3,000 (b)",9,10
3019,SDWCNTR,24468,24132,336,9758,14710,E07000229,E10000032,E12000008,45,"Above 20,000 (a)",4,30
3020,SDWRNNG,411,322,89,140,271,E07000228,E10000032,E12000008,45,"Below 1,000 (b)",13,10
3021,SDWSBRG,752,604,148,436,316,E07000227,E10000032,E12000008,45,"Below 1,000 (b)",13,10
3022,SDWSTCH,5797,4266,1531,2586,3211,E07000227,E10000032,E12000008,45,"Above 3,000 (b)",9,10
3023,SDWSTMN,452,369,83,250,202,E07000085,E10000014,E12000008,24,"Below 1,000 (b)",13,10
3024,SDWSWND,12158,12089,69,6216,5942,E07000229,E10000032,E12000008,45,"Above 10,000 (a)",6,30
3025,SDWTHDN,24226,18568,5658,5692,18534,E06000043,E99999999,E12000008,00ML,Small City,3,50
3026,SDWTRLV,19907,13659,6248,4097,15810,E07000094,E10000014,E12000008,24,"Above 10,000 (b)",7,30
3027,SDWTTNB,2754,2186,568,1661,1093,E06000046,E99999999,E12000008,00MW,"Above 1,000 (b)",11,10
3028,SDWVLSF,1115,939,176,438,677,E07000063,E10000011,E12000008,21,"Above 1,000 (b)",11,10
3029,SDWWST,14310,13430,880,5670,8640,E07000229,E10000032,E12000008,45,"Above 10,000 (a)",6,30
3030,SDYPTN,3258,2633,625,1529,1729,E07000224,E10000032,E12000008,45,"Above 3,000 (b)",9,10
3031,SDYRMTH,1206,931,275,578,628,E06000046,E99999999,E12000008,00MW,"Above 1,000 (b)",11,10
3032,SLAC,17407,10940,6467,2361,15046,E08000018,E99999999,E12000003,00CF,Large City,2,50
3033,SLADK,9092,6784,2308,2139,6953,E08000017,E99999999,E12000003,00CE,"Above 3,000 (b)",9,10
3034,SLAF,2413,2009,404,1764,649,E07000137,E10000019,E12000004,32,"Above 1,000 (a)",10,10
3035,SLARM,9803,7689,2114,5138,4665,E08000017,E99999999,E12000003,00CE,"Above 3,000 (b)",9,10
3036,SLASC,7116,6491,625,3945,3171,E08000018,E99999999,E12000003,00CF,"Above 3,000 (b)",9,10
3037,SLASH,1015,645,370,337,678,E07000038,E10000007,E12000004,17,"Above 1,000 (b)",11,10
3038,SLASK,4622,3251,1371,2188,2434,E08000017,E99999999,E12000003,00CE,"Above 3,000 (b)",9,10
3039,SLBAL,15380,11339,4041,5658,9722,E08000017,E99999999,E12000003,00CE,"Above 10,000 (a)",6,30
3040,SLBAR,1079,889,190,467,612,E07000142,E10000019,E12000004,32,"Above 1,000 (b)",11,10
3041,SLBAS,1328,688,640,557,771,E07000035,E10000007,E12000004,17,"Above 1,000 (b)",11,10
3042,SLBAW,4363,2549,1814,1706,2657,E08000017,E99999999,E12000003,00CE,"Above 3,000 (a)",8,30
3043,SLBB,558,176,382,37,521,E08000019,E99999999,E12000003,00CG,"Below 1,000 (b)",13,10
3044,SLBBY,1421,840,581,266,1155,E06000013,E99999999,E12000003,00FD,"Above 1,000 (b)",11,10
3045,SLBC,9490,6220,3270,1333,8157,E08000019,E99999999,E12000003,00CG,"Above 3,000 (b)",9,10
3046,SLBCC,59613,5495,54118,4001,55612,E06000013,E99999999,E12000003,00FD,"Above 20,000 (a)",4,30
3047,SLBEN,5908,5623,285,3638,2270,E08000017,E99999999,E12000003,00CE,"Above 3,000 (b)",9,10
3048,SLBH,19762,17638,2124,7648,12114,E08000019,E99999999,E12000003,00CG,Large City,2,50
3049,SLBHY,1656,1080,576,965,691,E07000139,E10000019,E12000004,32,"Above 1,000 (b)",11,10
3050,SLBLR,6488,5460,1028,3809,2679,E07000038,E10000007,E12000004,17,"Above 3,000 (b)",9,10
3051,SLBLY,1190,579,611,415,775,E07000171,E10000024,E12000004,37,"Above 1,000 (b)",11,10
3052,SLBMB,431,80,351,40,391,E07000137,E10000019,E12000004,32,"Below 1,000 (b)",13,10
3053,SLBNB,1060,786,274,404,656,E07000142,E10000019,E12000004,32,"Above 1,000 (b)",11,10
3054,SLBNN,660,213,447,80,580,E07000142,E10000019,E12000004,32,"Below 1,000 (b)",13,10
3055,SLBOB,537,72,465,40,497,E07000142,E10000019,E12000004,32,"Below 1,000 (b)",13,10
3056,SLBOI,8114,2883,5231,827,7287,E06000013,E99999999,E12000003,00FD,"Above 3,000 (b)",9,10
3057,SLBSM,2317,739,1578,590,1727,E07000139,E10000019,E12000004,32,"Above 1,000 (b)",11,10
3058,SLBUS,1858,1182,676,933,925,E06000013,E99999999,E12000003,00FD,"Above 1,000 (b)",11,10
3059,SLBWD,24336,12732,11604,2035,22301,E07000138,E10000019,E12000004,32,"Above 20,000 (b)",5,30
3060,SLBWH,27439,1307,26132,1215,26224,E06000013,E99999999,E12000003,00FD,"Above 20,000 (a)",4,30
3061,SLBY,36708,20280,16428,6753,29955,E08000016,E99999999,E12000003,00CC,Small City,3,50
3062,SLBYD,5984,5593,391,1692,4292,E08000017,E99999999,E12000003,00CE,"Above 3,000 (b)",9,10
3063,SLCBR,11088,7252,3836,4076,7012,E08000017,E99999999,E12000003,00CE,"Above 10,000 (b)",7,30
3064,SLCBY,3346,2556,790,1889,1457,E07000137,E10000019,E12000004,32,"Above 3,000 (b)",9,10
3065,SLCD,22489,15679,6810,4922,17567,E07000038,E10000007,E12000004,17,"Above 20,000 (b)",5,30
3066,SLCL,5570,5047,523,1836,3734,E07000033,E10000007,E12000004,17,"Above 3,000 (b)",9,10
3067,SLCLS,14698,14102,596,5639,9059,E06000012,E99999999,E12000003,00FC,"Above 10,000 (a)",6,30
3068,SLCLY,14953,10931,4022,2311,12642,E08000017,E99999999,E12000003,00CE,"Above 10,000 (b)",7,30
3069,SLCPL,2383,2102,281,1671,712,E08000017,E99999999,E12000003,00CE,"Above 1,000 (b)",11,10
3070,SLCRM,656,268,388,67,589,E07000142,E10000019,E12000004,32,"Below 1,000 (b)",13,10
3071,SLCTR,1768,1416,352,463,1305,E07000142,E10000019,E12000004,32,"Above 1,000 (b)",11,10
3072,SLCUD,11113,5768,5345,2139,8974,E08000036,E99999999,E12000003,00DB,"Above 10,000 (b)",7,30
3073,SLCX,9493,5568,3925,3144,6349,E07000038,E10000007,E12000004,17,"Above 3,000 (b)",9,10
3074,SLDC,11424,10384,1040,4784,6640,E08000017,E99999999,E12000003,00CE,"Above 10,000 (a)",6,30
3075,SLDCN,7354,7215,139,5128,2226,E08000017,E99999999,E12000003,00CE,"Above 3,000 (b)",9,10
3076,SLDF,8721,8338,383,4374,4347,E07000038,E10000007,E12000004,17,"Above 3,000 (a)",8,30
3077,SLDIO,10230,8060,2170,4269,5961,E08000018,E99999999,E12000003,00CF,Large City,2,50
3078,SLDR,8552,6924,1628,2631,5921,E08000036,E99999999,E12000003,00DB,"Above 3,000 (b)",9,10
3079,SLDUA,847,372,475,121,726,E07000171,E10000024,E12000004,37,"Below 1,000 (b)",13,10
3080,SLED,208,122,86,64,144,E07000037,E10000007,E12000004,17,"Below 1,000 (b)",13,10
3081,SLEF,16968,9637,7331,2260,14708,E08000018,E99999999,E12000003,00CF,Large City,2,50
3082,SLEK,5415,3606,1809,2104,3311,E07000038,E10000007,E12000004,17,"Above 3,000 (b)",9,10
3083,SLEP,3554,2028,1526,1757,1797,E06000013,E99999999,E12000003,00FD,"Above 3,000 (b)",9,10
3084,SLETF,421,207,214,152,269,E06000013,E99999999,E12000003,00FD,"Below 1,000 (b)",13,10
3085,SLFGY,4051,2514,1537,565,3486,E08000017,E99999999,E12000003,00CE,"Above 3,000 (b)",9,10
3086,SLFU,702,264,438,94,608,E07000137,E10000019,E12000004,32,"Below 1,000 (b)",13,10
3087,SLGB,11441,10051,1390,4933,6508,E07000171,E10000024,E12000004,37,"Above 10,000 (a)",6,30
3088,SLGD,1365,520,845,279,1086,E07000035,E10000007,E12000004,17,"Above 1,000 (b)",11,10
3089,SLGL,9443,9371,72,6155,3288,E07000038,E10000007,E12000004,17,"Above 3,000 (b)",9,10
3090,SLGMN,945,273,672,96,849,E07000171,E10000024,E12000004,37,"Below 1,000 (a)",12,10
3091,SLGTP,12516,8063,4453,2585,9931,E08000017,E99999999,E12000003,00CE,"Above 10,000 (a)",6,30
3092,SLGY,17480,17147,333,7079,10401,E06000012,E99999999,E12000003,00FC,"Above 10,000 (a)",6,30
3093,SLHBE,6590,4847,1743,1393,5197,E06000012,E99999999,E12000003,00FC,"Above 3,000 (b)",9,10
3094,SLHC,4141,3808,333,2947,1194,E07000137,E10000019,E12000004,32,"Above 3,000 (b)",9,10
3095,SLHD,3559,1937,1622,283,3276,E07000038,E10000007,E12000004,17,"Above 3,000 (b)",9,10
3096,SLHFT,888,354,534,200,688,E07000137,E10000019,E12000004,32,"Below 1,000 (b)",13,10
3097,SLHLG,6816,1880,4936,1127,5689,E07000142,E10000019,E12000004,32,"Above 3,000 (b)",9,10
3098,SLHLY,11972,9239,2733,2925,9047,E07000035,E10000007,E12000004,17,"Above 10,000 (b)",7,30
3099,SLHO,1936,824,1112,349,1587,E07000035,E10000007,E12000004,17,"Above 1,000 (b)",11,10
3100,SLHS,1457,935,522,820,637,E07000035,E10000007,E12000004,17,"Above 1,000 (a)",10,10
3101,SLHSN,332,142,190,92,240,E07000137,E10000019,E12000004,32,"Below 1,000 (b)",13,10
3102,SLHTW,8918,6772,2146,3469,5449,E08000017,E99999999,E12000003,00CE,"Above 3,000 (a)",8,30
3103,SLHW,949,267,682,167,782,E07000142,E10000019,E12000004,32,"Below 1,000 (b)",13,10
3104,SLHWD,6503,3272,3231,1501,5002,E07000038,E10000007,E12000004,17,"Above 3,000 (b)",9,10
3105,SLHX,1932,1280,652,767,1165,E07000171,E10000024,E12000004,37,"Above 1,000 (b)",11,10
3106,SLHY,11633,8524,3109,4419,7214,E08000018,E99999999,E12000003,00CF,Large City,2,50
3107,SLHYG,9503,9008,495,4615,4888,E08000018,E99999999,E12000003,00CF,"Above 3,000 (b)",9,10
3108,SLIMM,4786,4596,190,2785,2001,E06000013,E99999999,E12000003,00FD,"Above 3,000 (b)",9,10
3109,SLIN,27203,23327,3876,6502,20701,E07000038,E10000007,E12000004,17,"Above 20,000 (b)",5,30
3110,SLKHE,1078,508,570,69,1009,E06000013,E99999999,E12000003,00FD,"Above 1,000 (b)",11,10
3111,SLKIV,6180,4183,1997,1607,4573,E07000038,E10000007,E12000004,17,"Above 3,000 (b)",9,10
3112,SLKKB,2097,1466,631,803,1294,E06000013,E99999999,E12000003,00FD,"Above 1,000 (b)",11,10
3113,SLKL,1850,1445,405,1172,678,E06000013,E99999999,E12000003,00FD,"Above 1,000 (b)",11,10
3114,SLLAU,765,213,552,133,632,E07000142,E10000019,E12000004,32,"Below 1,000 (b)",13,10
3115,SLLH,9500,8666,834,4536,4964,E07000137,E10000019,E12000004,32,"Above 3,000 (a)",8,30
3116,SLLI,30772,19603,11169,7169,23603,E07000142,E10000019,E12000004,32,"Above 20,000 (b)",5,30
3117,SLMBY,8485,6836,1649,3980,4505,E08000017,E99999999,E12000003,00CE,"Above 3,000 (b)",9,10
3118,SLMC,917,394,523,278,639,E07000137,E10000019,E12000004,32,"Below 1,000 (a)",12,10
3119,SLMDH,11738,7116,4622,2097,9641,E08000018,E99999999,E12000003,00CF,Large City,2,50
3120,SLMEX,13092,10887,2205,4721,8371,E08000017,E99999999,E12000003,00CE,"Above 10,000 (a)",6,30
3121,SLMIM,2953,1942,1011,1582,1371,E07000139,E10000019,E12000004,32,"Above 1,000 (b)",11,10
3122,SLMIS,1835,1238,597,883,952,E07000171,E10000024,E12000004,37,"Above 1,000 (a)",10,10
3123,SLMK,3343,2934,409,2438,905,E07000142,E10000019,E12000004,32,"Above 3,000 (a)",8,30
3124,SLMLF,912,444,468,367,545,E07000137,E10000019,E12000004,32,"Below 1,000 (b)",13,10
3125,SLMOS,14947,9611,5336,4902,10045,E07000038,E10000007,E12000004,17,"Above 10,000 (b)",7,30
3126,SLMT,4384,4227,157,3138,1246,E07000137,E10000019,E12000004,32,"Above 3,000 (a)",8,30
3127,SLMTN,780,514,266,234,546,E07000139,E10000019,E12000004,32,"Below 1,000 (b)",13,10
3128,SLNBS,655,289,366,223,432,E07000142,E10000019,E12000004,32,"Below 1,000 (b)",13,10
3129,SLNCU,4690,2677,2013,2294,2396,E07000171,E10000024,E12000004,37,"Above 3,000 (b)",9,10
3130,SLNL,868,358,510,291,577,E06000013,E99999999,E12000003,00FD,"Below 1,000 (b)",13,10
3131,SLNSS,1102,773,329,643,459,E07000137,E10000019,E12000004,32,"Above 1,000 (a)",10,10
3132,SLNTY,1044,581,463,387,657,E06000012,E99999999,E12000003,00FC,"Above 1,000 (b)",11,10
3133,SLNVB,1687,1385,302,984,703,E07000139,E10000019,E12000004,32,"Above 1,000 (b)",11,10
3134,SLOB,3851,2826,1025,1602,2249,E08000016,E99999999,E12000003,00CC,"Above 3,000 (b)",9,10
3135,SLOLD,13820,9853,3967,3078,10742,E07000038,E10000007,E12000004,17,"Above 10,000 (b)",7,30
3136,SLOMR,566,94,472,20,546,E07000142,E10000019,E12000004,32,"Below 1,000 (b)",13,10
3137,SLOWF,727,526,201,434,293,E06000013,E99999999,E12000003,00FD,"Below 1,000 (b)",13,10
3138,SLPKX,5272,5041,231,1159,4113,E08000018,E99999999,E12000003,00CF,"Above 3,000 (b)",9,10
3139,SLPN,6958,4725,2233,2347,4611,E08000034,E99999999,E12000003,00CZ,"Above 3,000 (b)",9,10
3140,SLRAM,819,429,390,259,560,E07000171,E10000024,E12000004,37,"Below 1,000 (b)",13,10
3141,SLRF,12767,11203,1564,5000,7767,E07000171,E10000024,E12000004,37,"Above 10,000 (b)",7,30
3142,SLRH,16589,9048,7541,4099,12490,E08000018,E99999999,E12000003,00CF,Large City,2,50
3143,SLRHN,12812,11164,1648,4848,7964,E08000018,E99999999,E12000003,00CF,Large City,2,50
3144,SLRK,1862,486,1376,206,1656,E07000171,E10000024,E12000004,37,"Above 1,000 (b)",11,10
3145,SLRN,17920,12495,5425,4604,13316,E08000019,E99999999,E12000003,00CG,Large City,2,50
3146,SLRSN,6829,5933,896,4626,2203,E08000017,E99999999,E12000003,00CE,"Above 3,000 (b)",9,10
3147,SLRU,3642,2746,896,2172,1470,E07000139,E10000019,E12000004,32,"Above 3,000 (b)",9,10
3148,SLRWM,9243,7786,1457,4373,4870,E08000018,E99999999,E12000003,00CF,"Above 3,000 (b)",9,10
3149,SLRXN,1386,974,412,831,555,E06000013,E99999999,E12000003,00FD,"Above 1,000 (b)",11,10
3150,SLRY,10085,6296,3789,4525,5560,E08000036,E99999999,E12000003,00DB,"Above 10,000 (a)",6,30
3151,SLSAS,1116,301,815,98,1018,E06000013,E99999999,E12000003,00FD,"Above 1,000 (b)",11,10
3152,SLSAU,825,588,237,475,350,E07000171,E10000024,E12000004,37,"Below 1,000 (a)",12,10
3153,SLSAY,669,151,518,47,622,E07000137,E10000019,E12000004,32,"Below 1,000 (b)",13,10
3154,SLSC,17219,14447,2772,4186,13033,E06000012,E99999999,E12000003,00FC,"Above 10,000 (a)",6,30
3155,SLSCA,1311,620,691,100,1211,E07000142,E10000019,E12000004,32,"Above 1,000 (b)",11,10
3156,SLSCK,1416,525,891,131,1285,E07000137,E10000019,E12000004,32,"Above 1,000 (b)",11,10
3157,SLSEK,36728,16999,19729,5580,31148,E06000013,E99999999,E12000003,00FD,"Above 20,000 (a)",4,30
3158,SLSF,17968,16477,1491,9094,8874,E08000019,E99999999,E12000003,00CG,Large City,2,50
3159,SLSGO,532,155,377,14,518,E07000137,E10000019,E12000004,32,"Below 1,000 (b)",13,10
3160,SLSKT,3930,1302,2628,302,3628,E08000016,E99999999,E12000003,00CC,"Above 3,000 (b)",9,10
3161,SLSPD,763,181,582,43,720,E07000171,E10000024,E12000004,37,"Below 1,000 (b)",13,10
3162,SLSPK,6350,2791,3559,147,6203,E07000142,E10000019,E12000004,32,"Above 3,000 (b)",9,10
3163,SLSRB,327,250,77,130,197,E06000013,E99999999,E12000003,00FD,"Below 1,000 (b)",13,10
3164,SLST,7511,4090,3421,2014,5497,E08000016,E99999999,E12000003,00CC,Small City,3,50
3165,SLSTU,1107,274,833,160,947,E07000171,E10000024,E12000004,37,"Above 1,000 (b)",11,10
3166,SLSTW,1140,626,514,277,863,E07000142,E10000019,E12000004,32,"Above 1,000 (b)",11,10
3167,SLSU,2805,2721,84,1891,914,E07000137,E10000019,E12000004,32,"Above 1,000 (a)",10,10
3168,SLSW,17821,17736,85,9955,7866,E08000019,E99999999,E12000003,00CG,Large City,2,50
3169,SLSWB,407,153,254,75,332,E07000137,E10000019,E12000004,32,"Below 1,000 (b)",13,10
3170,SLSWL,396,88,308,52,344,E07000142,E10000019,E12000004,32,"Below 1,000 (b)",13,10
3171,SLSWY,1106,340,766,246,860,E07000175,E10000024,E12000004,37,"Above 1,000 (b)",11,10
3172,SLSXB,2809,1983,826,1356,1453,E07000142,E10000019,E12000004,32,"Above 1,000 (b)",11,10
3173,SLSY,9172,5135,4037,1935,7237,E07000038,E10000007,E12000004,17,"Above 3,000 (b)",9,10
3174,SLTE,1123,614,509,338,785,E07000171,E10000024,E12000004,37,"Above 1,000 (b)",11,10
3175,SLTF,503,258,245,109,394,E07000137,E10000019,E12000004,32,"Below 1,000 (b)",13,10
3176,SLTHY,5415,4862,553,2160,3255,E08000018,E99999999,E12000003,00CF,"Above 3,000 (b)",9,10
3177,SLTKL,4885,2902,1983,1968,2917,E08000017,E99999999,E12000003,00CE,"Above 3,000 (b)",9,10
3178,SLTLB,518,283,235,214,304,E07000142,E10000019,E12000004,32,"Below 1,000 (b)",13,10
3179,SLTX,2092,1397,695,1075,1017,E07000171,E10000024,E12000004,37,"Above 1,000 (b)",11,10
3180,SLWAD,6058,1827,4231,1266,4792,E07000138,E10000019,E12000004,32,"Above 3,000 (b)",9,10
3181,SLWB,27663,20608,7055,5822,21841,E08000019,E99999999,E12000003,00CG,Large City,2,50
3182,SLWBO,5533,3093,2440,1895,3638,E07000142,E10000019,E12000004,32,"Above 3,000 (b)",9,10
3183,SLWCY,300,53,247,10,290,E07000137,E10000019,E12000004,32,"Below 1,000 (b)",13,10
3184,SLWD,19486,12776,6710,3905,15581,E08000018,E99999999,E12000003,00CF,Large City,2,50
3185,SLWEL,2932,2663,269,1847,1085,E07000142,E10000019,E12000004,32,"Above 1,000 (b)",11,10
3186,SLWG,1441,958,483,854,587,E07000142,E10000019,E12000004,32,"Above 1,000 (b)",11,10
3187,SLWHT,5048,3120,1928,1259,3789,E07000033,E10000007,E12000004,17,"Above 3,000 (b)",9,10
3188,SLWIT,734,227,507,128,606,E07000137,E10000019,E12000004,32,"Below 1,000 (b)",13,10
3189,SLWKT,3122,2296,826,1805,1317,E06000013,E99999999,E12000003,00FD,"Above 3,000 (b)",9,10
3190,SLWKY,673,233,440,8,665,E07000142,E10000019,E12000004,32,"Below 1,000 (b)",13,10
3191,SLWKZ,16371,10549,5822,4617,11754,E08000018,E99999999,E12000003,00CF,Large City,2,50
3192,SLWL,14639,10332,4307,4141,10498,E08000018,E99999999,E12000003,00CF,Large City,2,50
3193,SLWM,9241,7254,1987,1922,7319,E06000012,E99999999,E12000003,00FC,"Above 3,000 (a)",8,30
3194,SLWOO,1113,498,615,213,900,E06000013,E99999999,E12000003,00FD,"Above 1,000 (b)",11,10
3195,SLWS,9490,8620,870,5577,3913,E08000019,E99999999,E12000003,00CG,"Above 3,000 (b)",9,10
3196,SLWSP,2636,2139,497,1656,980,E07000137,E10000019,E12000004,32,"Above 1,000 (b)",11,10
3197,SLWTH,10432,8371,2061,4390,6042,E08000018,E99999999,E12000003,00CF,Large City,2,50
3198,SLWW,20303,12208,8095,5455,14848,E07000171,E10000024,E12000004,37,"Above 20,000 (a)",4,30
3199,SLXDS,3391,1558,1833,1233,2158,E06000013,E99999999,E12000003,00FD,"Above 3,000 (b)",9,10
3200,SMAC,556,451,105,294,262,E07000096,E10000015,E12000006,26,"Below 1,000 (b)",13,10
3201,SMAD,3422,1609,1813,772,2650,E07000177,E10000025,E12000008,38,"Above 3,000 (b)",9,10
3202,SMAI,16494,13061,3433,5761,10733,E07000180,E10000025,E12000008,38,"Above 10,000 (b)",7,30
3203,SMAM,7901,7503,398,3072,4829,E07000005,E10000002,E12000008,11,"Above 3,000 (b)",9,10
3204,SMAN,2358,2011,347,1288,1070,E07000096,E10000015,E12000006,26,"Above 1,000 (b)",11,10
3205,SMAP,4924,4271,653,2845,2079,E06000056,E99999999,E12000006,00KC,"Above 3,000 (b)",9,10
3206,SMATL,1210,367,843,56,1154,E07000181,E10000025,E12000008,38,"Above 1,000 (b)",11,10
3207,SMAW,1097,886,211,750,347,E06000056,E99999999,E12000006,00KC,"Above 1,000 (b)",11,10
3208,SMAY,26783,21588,5195,7550,19233,E07000004,E10000002,E12000008,11,"Above 20,000 (b)",5,30
3209,SMBA,27326,13614,13712,4963,22363,E06000042,E99999999,E12000008,00MG,"Above 20,000 (b)",5,30
3210,SMBB,20928,18221,2707,6910,14018,E07000177,E10000025,E12000008,38,"Above 20,000 (b)",5,30
3211,SMBC,5406,5171,235,4107,1299,E07000099,E10000015,E12000006,26,"Above 3,000 (b)",9,10
3212,SMBCD,7720,6161,1559,2880,4840,E07000006,E10000002,E12000008,11,"Above 3,000 (b)",9,10
3213,SMBD,3015,2094,921,1598,1417,E07000102,E10000015,E12000006,26,"Above 3,000 (b)",9,10
3214,SMBDG,994,700,294,277,717,E07000007,E10000002,E12000008,11,"Below 1,000 (b)",13,10
3215,SMBEN,440,402,38,300,140,E07000242,E10000015,E12000006,26,"Below 1,000 (b)",13,10
3216,SMBF,27522,21998,5524,8928,18594,E06000055,E99999999,E12000006,00KB,"Above 20,000 (a)",4,30
3217,SMBG,1607,1096,511,377,1230,E07000241,E10000015,E12000006,26,"Above 1,000 (b)",11,10
3218,SMBH,1257,781,476,446,811,E06000056,E99999999,E12000006,00KC,"Above 1,000 (b)",11,10
3219,SMBI,16761,14264,2497,5458,11303,E07000177,E10000025,E12000008,38,"Above 10,000 (a)",6,30
3220,SMBK,10437,9201,1236,5077,5360,E07000096,E10000015,E12000006,26,"Above 10,000 (b)",7,30
3221,SMBL,2515,1741,774,1186,1329,E07000177,E10000025,E12000008,38,"Above 1,000 (b)",11,10
3222,SMBNC,1782,1195,587,1081,701,E07000181,E10000025,E12000008,38,"Above 1,000 (b)",11,10
3223,SMBRD,1391,1022,369,678,713,E07000079,E10000013,E12000009,23,"Above 1,000 (b)",11,10
3224,SMBRL,1965,576,1389,493,1472,E07000177,E10000025,E12000008,38,"Above 1,000 (b)",11,10
3225,SMBRS,763,516,247,328,435,E07000221,E10000031,E12000005,44,"Below 1,000 (b)",13,10
3226,SMBT,14813,8985,5828,3154,11659,E07000004,E10000002,E12000008,11,"Above 10,000 (b)",7,30
3227,SMBTH,474,111,363,45,429,E07000221,E10000031,E12000005,44,"Below 1,000 (b)",13,10
3228,SMBTN,916,673,243,281,635,E07000177,E10000025,E12000008,38,"Below 1,000 (b)",13,10
3229,SMBU,7646,6594,1052,3983,3663,E07000004,E10000002,E12000008,11,"Above 3,000 (a)",8,30
3230,SMBWD,9082,8617,465,4285,4797,E06000056,E99999999,E12000006,00KC,"Above 3,000 (b)",9,10
3231,SMBWY,1196,826,370,704,492,E07000180,E10000025,E12000008,38,"Above 1,000 (b)",11,10
3232,SMBY,6894,6358,536,4166,2728,E07000177,E10000025,E12000008,38,"Above 3,000 (b)",9,10
3233,SMBZ,3492,2081,1411,180,3312,E07000180,E10000025,E12000008,38,"Above 3,000 (a)",8,30
3234,SMCA,4507,1519,2988,124,4383,E06000055,E99999999,E12000006,00KB,"Above 3,000 (b)",9,10
3235,SMCAR,7051,6466,585,3256,3795,E07000181,E10000025,E12000008,38,"Above 3,000 (b)",9,10
3236,SMCBY,1508,1471,37,1366,142,E07000181,E10000025,E12000008,38,"Above 1,000 (a)",10,10
3237,SMCD,589,420,169,329,260,E07000181,E10000025,E12000008,38,"Below 1,000 (a)",12,10
3238,SMCDU,958,618,340,258,700,E07000180,E10000025,E12000008,38,"Below 1,000 (b)",13,10
3239,SMCG,4688,2790,1898,1836,2852,E07000102,E10000015,E12000006,26,"Above 3,000 (b)",9,10
3240,SMCHH,672,188,484,110,562,E07000011,E10000003,E12000006,12,"Below 1,000 (b)",13,10
3241,SMCHN,3356,2600,756,614,2742,E07000096,E10000015,E12000006,26,"Above 3,000 (b)",9,10
3242,SMCHO,1083,211,872,25,1058,E07000177,E10000025,E12000008,38,"Above 1,000 (b)",11,10
3243,SMCHY,914,555,359,149,765,E07000096,E10000015,E12000006,26,"Below 1,000 (b)",13,10
3244,SMCI,1564,1495,69,1252,312,E07000241,E10000015,E12000006,26,"Above 1,000 (b)",11,10
3245,SMCN,3821,3473,348,2395,1426,E07000181,E10000025,E12000008,38,"Above 3,000 (a)",8,30
3246,SMCNR,5330,4757,573,1885,3445,E07000180,E10000025,E12000008,38,"Above 3,000 (b)",9,10
3247,SMCO,20137,18219,1918,6461,13676,E07000179,E10000025,E12000008,38,"Above 20,000 (b)",5,30
3248,SMCR,2938,2342,596,1259,1679,E06000056,E99999999,E12000006,00KC,"Above 1,000 (b)",11,10
3249,SMCRP,867,568,299,355,512,E07000221,E10000031,E12000005,44,"Below 1,000 (b)",13,10
3250,SMCRT,1107,456,651,202,905,E07000177,E10000025,E12000008,38,"Above 1,000 (b)",11,10
3251,SMCSH,10827,9330,1497,4415,6412,E07000005,E10000002,E12000008,11,"Above 10,000 (b)",7,30
3252,SMCTN,692,551,141,139,553,E07000180,E10000025,E12000008,38,"Below 1,000 (b)",13,10
3253,SMCWD,612,370,242,241,371,E07000177,E10000025,E12000008,38,"Below 1,000 (b)",13,10
3254,SMDB,17039,15677,1362,6931,10108,E06000056,E99999999,E12000006,00KC,"Above 10,000 (b)",7,30
3255,SMDC,13329,12450,879,5762,7567,E07000180,E10000025,E12000008,38,"Above 10,000 (b)",7,30
3256,SMDD,1190,825,365,620,570,E07000177,E10000025,E12000008,38,"Above 1,000 (a)",10,10
3257,SMEB,3056,2255,801,1000,2056,E06000056,E99999999,E12000006,00KC,"Above 3,000 (b)",9,10
3258,SMEG,591,294,297,30,561,E07000221,E10000031,E12000005,44,"Below 1,000 (b)",13,10
3259,SMENS,709,483,226,410,299,E07000181,E10000025,E12000008,38,"Below 1,000 (b)",13,10
3260,SMEY,3106,2378,728,2169,937,E07000181,E10000025,E12000008,38,"Above 3,000 (b)",9,10
3261,SMFB,684,151,533,109,575,E07000221,E10000031,E12000005,44,"Below 1,000 (b)",13,10
3262,SMFH,1603,222,1381,112,1491,E07000180,E10000025,E12000008,38,"Above 1,000 (b)",11,10
3263,SMFI,1289,612,677,146,1143,E07000177,E10000025,E12000008,38,"Above 1,000 (a)",10,10
3264,SMFK,7251,6110,1141,4571,2680,E06000056,E99999999,E12000006,00KC,"Above 3,000 (b)",9,10
3265,SMFN,1035,365,670,330,705,E07000221,E10000031,E12000005,44,"Above 1,000 (b)",11,10
3266,SMFRD,2700,2101,599,492,2208,E07000181,E10000025,E12000008,38,"Above 1,000 (b)",11,10
3267,SMFW,904,436,468,300,604,E07000177,E10000025,E12000008,38,"Below 1,000 (b)",13,10
3268,SMGA,1810,1666,144,1493,317,E06000056,E99999999,E12000006,00KC,"Above 1,000 (b)",11,10
3269,SMGB,1412,904,508,834,578,E06000056,E99999999,E12000006,00KC,"Above 1,000 (b)",11,10
3270,SMGBL,822,566,256,301,521,E07000004,E10000002,E12000008,11,"Below 1,000 (b)",13,10
3271,SMGG,728,554,174,421,307,E07000012,E10000003,E12000006,12,"Below 1,000 (b)",13,10
3272,SMGM,3825,2160,1665,861,2964,E07000005,E10000002,E12000008,11,"Above 3,000 (b)",9,10
3273,SMGMT,872,589,283,281,591,E07000179,E10000025,E12000008,38,"Below 1,000 (b)",13,10
3274,SMGN,1832,1125,707,579,1253,E07000179,E10000025,E12000008,38,"Above 1,000 (b)",11,10
3275,SMGT,412,138,274,80,332,E07000177,E10000025,E12000008,38,"Below 1,000 (b)",13,10
3276,SMGUD,1106,532,574,281,825,E07000177,E10000025,E12000008,38,"Above 1,000 (b)",11,10
3277,SMHA,1246,381,865,118,1128,E06000055,E99999999,E12000006,00KB,"Above 1,000 (b)",11,10
3278,SMHD,16503,15973,530,5136,11367,E07000179,E10000025,E12000008,38,"Above 10,000 (a)",6,30
3279,SMHDM,2958,2338,620,2141,817,E07000004,E10000002,E12000008,11,"Above 1,000 (a)",10,10
3280,SMHE,1666,1651,15,775,891,E06000056,E99999999,E12000006,00KC,"Above 1,000 (a)",10,10
3281,SMHGN,5794,5277,517,2162,3632,E07000005,E10000002,E12000008,11,"Above 3,000 (b)",9,10
3282,SMHH,37286,21052,16234,5740,31546,E07000240,E10000015,E12000006,26,"Above 20,000 (b)",5,30
3283,SMHI,18086,15271,2815,6379,11707,E07000099,E10000015,E12000006,26,"Above 10,000 (a)",6,30
3284,SMHN,1320,956,364,838,482,E07000221,E10000031,E12000005,44,"Above 1,000 (b)",11,10
3285,SMHO,1186,665,521,461,725,E06000056,E99999999,E12000006,00KC,"Above 1,000 (b)",11,10
3286,SMHPR,1111,387,724,62,1049,E07000005,E10000002,E12000008,11,"Above 1,000 (b)",11,10
3287,SMHR,12703,10718,1985,4103,8600,E07000240,E10000015,E12000006,26,"Above 10,000 (b)",7,30
3288,SMHS,1634,1046,588,828,806,E07000155,E10000021,E12000004,34,"Above 1,000 (b)",11,10
3289,SMHUR,14638,11921,2717,5095,9543,E06000056,E99999999,E12000006,00KC,"Above 10,000 (b)",7,30
3290,SMHXT,2530,2173,357,1752,778,E06000056,E99999999,E12000006,00KC,"Above 1,000 (b)",11,10
3291,SMHY,26142,18123,8019,4927,21215,E07000007,E10000002,E12000008,11,"Above 20,000 (b)",5,30
3292,SMHZ,697,468,229,393,304,E06000056,E99999999,E12000006,00KC,"Below 1,000 (b)",13,10
3293,SMICK,1113,738,375,305,808,E07000004,E10000002,E12000008,11,"Above 1,000 (b)",11,10
3294,SMIMN,587,368,219,316,271,E07000221,E10000031,E12000005,44,"Below 1,000 (b)",13,10
3295,SMKBN,3443,2777,666,2154,1289,E07000007,E10000002,E12000008,11,"Above 3,000 (b)",9,10
3296,SMKH,1324,621,703,375,949,E07000079,E10000013,E12000009,23,"Above 1,000 (b)",11,10
3297,SMKI,8610,7981,629,4842,3768,E07000177,E10000025,E12000008,38,"Above 3,000 (b)",9,10
3298,SMKO,5742,5127,615,1850,3892,E07000241,E10000015,E12000006,26,"Above 3,000 (b)",9,10
3299,SMKP,1147,1001,146,634,513,E07000240,E10000015,E12000006,26,"Above 1,000 (b)",11,10
3300,SMKT,12223,10993,1230,5817,6406,E06000055,E99999999,E12000006,00KB,"Above 10,000 (b)",7,30
3301,SMLA,1627,1488,139,842,785,E06000056,E99999999,E12000006,00KC,"Above 1,000 (b)",11,10
3302,SMLBD,17416,16214,1202,6092,11324,E06000056,E99999999,E12000006,00KC,"Above 10,000 (a)",6,30
3303,SMLC,598,322,276,106,492,E07000221,E10000031,E12000005,44,"Below 1,000 (b)",13,10
3304,SMLD,681,298,383,201,480,E07000155,E10000021,E12000004,34,"Below 1,000 (b)",13,10
3305,SMLEA,35614,21533,14081,7132,28482,E06000056,E99999999,E12000006,00KC,"Above 20,000 (b)",5,30
3306,SMLF,3356,3248,108,2129,1227,E07000096,E10000015,E12000006,26,"Above 3,000 (b)",9,10
3307,SMLGN,904,455,449,273,631,E07000096,E10000015,E12000006,26,"Below 1,000 (b)",13,10
3308,SMLH,15716,14108,1608,5349,10367,E06000056,E99999999,E12000006,00KC,"Above 10,000 (b)",7,30
3309,SMLN,3888,1676,2212,1246,2642,E07000007,E10000002,E12000008,11,"Above 3,000 (b)",9,10
3310,SMLR,1458,1154,304,964,494,E07000004,E10000002,E12000008,11,"Above 1,000 (b)",11,10
3311,SMLSN,5063,2497,2566,2110,2953,E06000056,E99999999,E12000006,00KC,"Above 3,000 (b)",9,10
3312,SMLT,38999,25936,13063,11848,27151,E06000056,E99999999,E12000006,00KC,"Above 20,000 (b)",5,30
3313,SMLW,1708,1554,154,712,996,E07000181,E10000025,E12000008,38,"Above 1,000 (b)",11,10
3314,SMMC,2416,1931,485,1670,746,E07000177,E10000025,E12000008,38,"Above 1,000 (b)",11,10
3315,SMMCM,981,812,169,652,329,E07000180,E10000025,E12000008,38,"Below 1,000 (b)",13,10
3316,SMMM,2793,2366,427,2247,546,E07000221,E10000031,E12000005,44,"Above 1,000 (b)",11,10
3317,SMMS,1360,403,957,252,1108,E07000004,E10000002,E12000008,11,"Above 1,000 (b)",11,10
3318,SMMSY,325,171,154,105,220,E07000177,E10000025,E12000008,38,"Below 1,000 (b)",13,10
3319,SMMY,3678,1601,2077,1380,2298,E07000240,E10000015,E12000006,26,"Above 3,000 (b)",9,10
3320,SMNCY,633,332,301,291,342,E06000042,E99999999,E12000008,00MG,"Below 1,000 (b)",13,10
3321,SMNHM,1662,883,779,22,1640,E07000180,E10000025,E12000008,38,"Above 1,000 (b)",11,10
3322,SMNL,963,717,246,226,737,E06000056,E99999999,E12000006,00KC,"Below 1,000 (b)",13,10
3323,SMNM,529,331,198,273,256,E07000004,E10000002,E12000008,11,"Below 1,000 (b)",13,10
3324,SMNP,11553,7338,4215,3458,8095,E06000042,E99999999,E12000008,00MG,"Above 10,000 (b)",7,30
3325,SMNPL,4626,2541,2085,696,3930,E07000007,E10000002,E12000008,11,"Above 3,000 (b)",9,10
3326,SMOA,6054,2460,3594,940,5114,E06000055,E99999999,E12000006,00KB,"Above 3,000 (b)",9,10
3327,SMOF,12652,12620,32,3973,8679,E07000180,E10000025,E12000008,38,"Above 10,000 (a)",6,30
3328,SMOL,1074,452,622,423,651,E06000056,E99999999,E12000006,00KC,"Above 1,000 (b)",11,10
3329,SMOY,3661,3278,383,2950,711,E07000155,E10000021,E12000004,34,"Above 3,000 (b)",9,10
3330,SMPEN,9336,7087,2249,2807,6529,E07000005,E10000002,E12000008,11,"Above 3,000 (a)",8,30
3331,SMPRB,5277,3963,1314,2872,2405,E07000007,E10000002,E12000008,11,"Above 3,000 (b)",9,10
3332,SMPT,2541,2351,190,1317,1224,E06000056,E99999999,E12000006,00KC,"Above 1,000 (b)",11,10
3333,SMRDB,4488,2382,2106,1778,2710,E07000240,E10000015,E12000006,26,"Above 3,000 (b)",9,10
3334,SMRE,2253,2013,240,1620,633,E07000007,E10000002,E12000008,11,"Above 1,000 (a)",10,10
3335,SMRGT,1205,237,968,174,1031,E06000056,E99999999,E12000006,00KC,"Above 1,000 (b)",11,10
3336,SMRMN,970,576,394,328,642,E07000181,E10000025,E12000008,38,"Below 1,000 (b)",13,10
3337,SMROW,3350,1399,1951,100,3250,E07000180,E10000025,E12000008,38,"Above 3,000 (b)",9,10
3338,SMRSL,1215,559,656,463,752,E06000055,E99999999,E12000006,00KB,"Above 1,000 (b)",11,10
3339,SMRVN,9213,4502,4711,288,8925,E06000055,E99999999,E12000006,00KB,"Above 3,000 (b)",9,10
3340,SMSA,5406,5217,189,3883,1523,E06000056,E99999999,E12000006,00KC,"Above 3,000 (b)",9,10
3341,SMSAN,1399,524,875,357,1042,E07000177,E10000025,E12000008,38,"Above 1,000 (a)",10,10
3342,SMSAY,1326,317,1009,164,1162,E07000177,E10000025,E12000008,38,"Above 1,000 (b)",11,10
3343,SMSC,1963,968,995,801,1162,E07000004,E10000002,E12000008,11,"Above 1,000 (b)",11,10
3344,SMSDM,1759,352,1407,222,1537,E07000179,E10000025,E12000008,38,"Above 1,000 (b)",11,10
3345,SMSE,5075,3452,1623,413,4662,E07000004,E10000002,E12000008,11,"Above 3,000 (a)",8,30
3346,SMSFD,8243,4466,3777,1841,6402,E06000056,E99999999,E12000006,00KC,"Above 3,000 (b)",9,10
3347,SMSG,1398,313,1085,164,1234,E07000155,E10000021,E12000004,34,"Above 1,000 (b)",11,10
3348,SMSGN,1841,684,1157,126,1715,E06000056,E99999999,E12000006,00KC,"Above 1,000 (b)",11,10
3349,SMSGT,500,313,187,198,302,E07000155,E10000021,E12000004,34,"Below 1,000 (b)",13,10
3350,SMSH,3199,2680,519,2308,891,E07000221,E10000031,E12000005,44,"Above 3,000 (a)",8,30
3351,SMSHP,6058,5930,128,1373,4685,E07000242,E10000015,E12000006,26,"Above 3,000 (b)",9,10
3352,SMSLK,1285,684,601,386,899,E07000181,E10000025,E12000008,38,"Above 1,000 (b)",11,10
3353,SMSM,10689,9983,706,4359,6330,E07000177,E10000025,E12000008,38,"Above 10,000 (b)",7,30
3354,SMSMV,6608,4837,1771,1070,5538,E07000004,E10000002,E12000008,11,"Above 3,000 (b)",9,10
3355,SMSNB,1660,1113,547,812,848,E07000152,E10000021,E12000004,34,"Above 1,000 (b)",11,10
3356,SMSNC,2837,1718,1119,1027,1810,E07000180,E10000025,E12000008,38,"Above 1,000 (b)",11,10
3357,SMSNF,1016,932,84,683,333,E07000181,E10000025,E12000008,38,"Above 1,000 (b)",11,10
3358,SMSSF,7579,5494,2085,3171,4408,E07000155,E10000021,E12000004,34,"Above 3,000 (b)",9,10
3359,SMSSO,3065,1936,1129,1121,1944,E06000056,E99999999,E12000006,00KC,"Above 3,000 (b)",9,10
3360,SMST,856,735,121,575,281,E07000004,E10000002,E12000008,11,"Below 1,000 (b)",13,10
3361,SMSTF,7279,5476,1803,2131,5148,E06000056,E99999999,E12000006,00KC,"Above 3,000 (b)",9,10
3362,SMSTJ,953,538,415,140,813,E07000177,E10000025,E12000008,38,"Below 1,000 (b)",13,10
3363,SMSU,25203,15578,9625,4995,20208,E07000004,E10000002,E12000008,11,"Above 20,000 (b)",5,30
3364,SMSUB,605,307,298,173,432,E06000056,E99999999,E12000006,00KC,"Below 1,000 (b)",13,10
3365,SMSWD,2005,1506,499,625,1380,E07000181,E10000025,E12000008,38,"Above 1,000 (b)",11,10
3366,SMSWF,797,407,390,102,695,E07000177,E10000025,E12000008,38,"Below 1,000 (b)",13,10
3367,SMSX,28792,17512,11280,5124,23668,E07000099,E10000015,E12000006,26,"Above 20,000 (b)",5,30
3368,SMSYR,620,352,268,266,354,E07000155,E10000021,E12000004,34,"Below 1,000 (b)",13,10
3369,SMTA,6079,5546,533,4180,1899,E07000004,E10000002,E12000008,11,"Above 3,000 (b)",9,10
3370,SMTAK,605,453,152,350,255,E07000177,E10000025,E12000008,38,"Below 1,000 (b)",13,10
3371,SMTL,639,466,173,241,398,E07000005,E10000002,E12000008,11,"Below 1,000 (b)",13,10
3372,SMTN,3133,1998,1135,1877,1256,E06000056,E99999999,E12000006,00KC,"Above 3,000 (b)",9,10
3373,SMTR,5925,5671,254,3672,2253,E07000096,E10000015,E12000006,26,"Above 3,000 (a)",8,30
3374,SMTU,1198,562,636,434,764,E06000042,E99999999,E12000008,00MG,"Above 1,000 (b)",11,10
3375,SMTY,861,487,374,370,491,E07000221,E10000031,E12000005,44,"Below 1,000 (b)",13,10
3376,SMUH,1099,927,172,223,876,E07000177,E10000025,E12000008,38,"Above 1,000 (b)",11,10
3377,SMWAD,1803,674,1129,130,1673,E07000004,E10000002,E12000008,11,"Above 1,000 (b)",11,10
3378,SMWB,418,69,349,13,405,E06000056,E99999999,E12000006,00KC,"Below 1,000 (b)",13,10
3379,SMWC,2462,1943,519,1618,844,E07000177,E10000025,E12000008,38,"Above 1,000 (b)",11,10
3380,SMWE,4032,3488,544,1904,2128,E07000005,E10000002,E12000008,11,"Above 3,000 (b)",9,10
3381,SMWEP,4009,3719,290,1776,2233,E07000241,E10000015,E12000006,26,"Above 3,000 (b)",9,10
3382,SMWHY,1427,669,758,408,1019,E07000180,E10000025,E12000008,38,"Above 1,000 (b)",11,10
3383,SMWI,14085,13017,1068,5658,8427,E07000181,E10000025,E12000008,38,"Above 10,000 (b)",7,30
3384,SMWKN,2134,682,1452,517,1617,E07000099,E10000015,E12000006,26,"Above 1,000 (b)",11,10
3385,SMWLS,3076,1669,1407,1009,2067,E06000056,E99999999,E12000006,00KC,"Above 3,000 (b)",9,10
3386,SMWLY,2712,2356,356,1723,989,E07000179,E10000025,E12000008,38,"Above 1,000 (a)",10,10
3387,SMWN,8690,6167,2523,3770,4920,E07000180,E10000025,E12000008,38,"Above 3,000 (b)",9,10
3388,SMWNG,2245,726,1519,53,2192,E07000096,E10000015,E12000006,26,"Above 1,000 (b)",11,10
3389,SMWRB,2579,628,1951,336,2243,E07000179,E10000025,E12000008,38,"Above 1,000 (b)",11,10
3390,SMWS,6289,3056,3233,2125,4164,E06000056,E99999999,E12000006,00KC,"Above 3,000 (b)",9,10
3391,SMWSN,2235,443,1792,370,1865,E07000099,E10000015,E12000006,26,"Above 1,000 (b)",11,10
3392,SMWSW,756,335,421,263,493,E06000056,E99999999,E12000006,00KC,"Below 1,000 (b)",13,10
3393,SMWTC,980,622,358,380,600,E07000004,E10000002,E12000008,11,"Below 1,000 (b)",13,10
3394,SMWTD,2810,2312,498,1937,873,E07000240,E10000015,E12000006,26,"Above 1,000 (a)",10,10
3395,SMWTW,1070,493,577,406,664,E07000099,E10000015,E12000006,26,"Above 1,000 (b)",11,10
3396,SMWV,17501,9835,7666,3541,13960,E07000155,E10000021,E12000004,34,"Above 10,000 (b)",7,30
3397,SMWW,3291,2401,890,2228,1063,E07000004,E10000002,E12000008,11,"Above 3,000 (b)",9,10
3398,SMWX,1656,635,1021,181,1475,E07000221,E10000031,E12000005,44,"Above 1,000 (b)",11,10
3399,SMWZ,1512,1111,401,575,937,E06000056,E99999999,E12000006,00KC,"Above 1,000 (b)",11,10
3400,SMYG,1420,1215,205,435,985,E07000155,E10000021,E12000004,34,"Above 1,000 (b)",11,10
3401,SSABE,1147,819,328,751,396,E06000054,E99999999,E12000009,00HY,"Above 1,000 (a)",10,10
3402,SSABS,2506,1105,1401,795,1711,E06000025,E99999999,E12000009,00HD,"Above 1,000 (b)",11,10
3403,SSADN,770,338,432,39,731,E07000083,E10000013,E12000009,23,"Below 1,000 (b)",13,10
3404,SSAFD,993,627,366,391,602,E07000079,E10000013,E12000009,23,"Below 1,000 (a)",12,10
3405,SSAHY,478,262,216,137,341,E07000180,E10000025,E12000008,38,"Below 1,000 (b)",13,10
3406,SSALM,12007,4474,7533,783,11224,E06000025,E99999999,E12000009,00HD,Large City,2,50
3407,SSAMB,2133,1853,280,1174,959,E07000082,E10000013,E12000009,23,"Above 1,000 (b)",11,10
3408,SSAVO,6924,5009,1915,1462,5462,E06000025,E99999999,E12000009,00HD,"Above 3,000 (b)",9,10
3409,SSAVY,455,313,142,180,275,E06000054,E99999999,E12000009,00HY,"Below 1,000 (b)",13,10
3410,SSAXB,1461,1147,314,531,930,E07000188,E10000027,E12000009,40,"Above 1,000 (a)",10,10
3411,SSBAD,702,339,363,127,575,E06000025,E99999999,E12000009,00HD,"Below 1,000 (b)",13,10
3412,SSBAL,1309,454,855,310,999,E07000189,E10000027,E12000009,40,"Above 1,000 (b)",11,10
3413,SSBAN,2525,1637,888,1093,1432,E07000188,E10000027,E12000009,40,"Above 1,000 (b)",11,10
3414,SSBAT,4673,3696,977,1450,3223,E06000022,E99999999,E12000009,00HA,"Above 3,000 (b)",9,10
3415,SSBBG,1271,768,503,385,886,E06000054,E99999999,E12000009,00HY,"Above 1,000 (a)",10,10
3416,SSBBN,6707,6071,636,1842,4865,E06000030,E99999999,E12000009,00HX,"Above 3,000 (b)",9,10
3417,SSBBY,467,316,151,219,248,E07000079,E10000013,E12000009,23,"Below 1,000 (b)",13,10
3418,SSBCL,7863,7070,793,4000,3863,E07000083,E10000013,E12000009,23,"Above 3,000 (b)",9,10
3419,SSBEC,1304,775,529,425,879,E06000054,E99999999,E12000009,00HY,"Above 1,000 (b)",11,10
3420,SSBED,15811,15811,0,11161,4650,E06000023,E99999999,E12000009,00HB,Large City,2,50
3421,SSBHN,681,422,259,222,459,E06000054,E99999999,E12000009,00HY,"Below 1,000 (b)",13,10
3422,SSBIS,15584,14893,691,4843,10741,E06000022,E99999999,E12000009,00HA,"Above 10,000 (b)",7,30
3423,SSBIT,8547,6633,1914,1274,7273,E06000022,E99999999,E12000009,00HA,"Above 3,000 (b)",9,10
3424,SSBKE,2292,1223,1069,1074,1218,E06000025,E99999999,E12000009,00HD,"Above 1,000 (b)",11,10
3425,SSBKL,301,202,99,152,149,E07000181,E10000025,E12000008,38,"Below 1,000 (b)",13,10
3426,SSBKY,1635,192,1443,42,1593,E07000080,E10000013,E12000009,23,"Above 1,000 (b)",11,10
3427,SSBLA,1008,620,388,482,526,E06000022,E99999999,E12000009,00HA,"Above 1,000 (b)",11,10
3428,SSBLE,6933,5595,1338,2077,4856,E07000188,E10000027,E12000009,40,"Above 3,000 (b)",9,10
3429,SSBMN,580,177,403,58,522,E07000235,E10000034,E12000005,47,"Below 1,000 (b)",13,10
3430,SSBOA,5934,5085,849,3507,2427,E06000054,E99999999,E12000009,00HY,"Above 3,000 (b)",9,10
3431,SSBOW,3164,2017,1147,1450,1714,E07000079,E10000013,E12000009,23,"Above 3,000 (b)",9,10
3432,SSBOX,1876,1025,851,727,1149,E06000022,E99999999,E12000009,00HA,"Above 1,000 (b)",11,10
3433,SSBRI,4805,3210,1595,977,3828,E07000082,E10000013,E12000009,23,"Above 3,000 (b)",9,10
3434,SSBRK,2256,1850,406,1122,1134,E06000054,E99999999,E12000009,00HY,"Above 1,000 (b)",11,10
3435,SSBRN,2679,1159,1520,913,1766,E07000238,E10000034,E12000005,47,"Above 1,000 (a)",10,10
3436,SSBRO,1221,822,399,338,883,E06000054,E99999999,E12000009,00HY,"Above 1,000 (b)",11,10
3437,SSBRT,1076,855,221,320,756,E06000054,E99999999,E12000009,00HY,"Above 1,000 (b)",11,10
3438,SSBRU,1614,1310,304,1034,580,E07000189,E10000027,E12000009,40,"Above 1,000 (a)",10,10
3439,SSBRW,821,428,393,207,614,E06000054,E99999999,E12000009,00HY,"Below 1,000 (b)",13,10
3440,SSBSY,1032,468,564,316,716,E07000082,E10000013,E12000009,23,"Above 1,000 (a)",10,10
3441,SSBWD,21069,13102,7967,4651,16418,E07000082,E10000013,E12000009,23,"Above 20,000 (b)",5,30
3442,SSCAL,9405,8128,1277,5377,4028,E06000054,E99999999,E12000009,00HY,"Above 3,000 (a)",8,30
3443,SSCAN,1102,396,706,87,1015,E06000054,E99999999,E12000009,00HY,"Above 1,000 (b)",11,10
3444,SSCAS,483,435,48,257,226,E07000079,E10000013,E12000009,23,"Below 1,000 (b)",13,10
3445,SSCBD,8056,7018,1038,2768,5288,E06000022,E99999999,E12000009,00HA,"Above 3,000 (b)",9,10
3446,SSCCM,915,352,563,166,749,E06000054,E99999999,E12000009,00HY,"Below 1,000 (b)",13,10
3447,SSCDN,1300,1067,233,902,398,E06000054,E99999999,E12000009,00HY,"Above 1,000 (b)",11,10
3448,SSCDO,914,611,303,387,527,E06000022,E99999999,E12000009,00HA,"Below 1,000 (b)",13,10
3449,SSCDR,3136,2850,286,2446,690,E07000187,E10000027,E12000009,40,"Above 3,000 (b)",9,10
3450,SSCGE,1864,918,946,312,1552,E07000082,E10000013,E12000009,23,"Above 1,000 (b)",11,10
3451,SSCHA,1053,427,626,239,814,E06000054,E99999999,E12000009,00HY,"Above 1,000 (b)",11,10
3452,SSCHI,15744,12525,3219,5259,10485,E06000054,E99999999,E12000009,00HY,"Above 10,000 (a)",6,30
3453,SSCHN,6891,5628,1263,2780,4111,E07000081,E10000013,E12000009,23,"Above 3,000 (b)",9,10
3454,SSCHT,935,338,597,172,763,E06000054,E99999999,E12000009,00HY,"Below 1,000 (a)",12,10
3455,SSCHU,1267,1036,231,658,609,E07000188,E10000027,E12000009,40,"Above 1,000 (b)",11,10
3456,SSCIN,5900,5378,522,3985,1915,E07000080,E10000013,E12000009,23,"Above 3,000 (b)",9,10
3457,SSCIR,11252,9774,1478,5311,5941,E07000079,E10000013,E12000009,23,"Above 10,000 (a)",6,30
3458,SSCLE,10865,10145,720,4780,6085,E06000024,E99999999,E12000009,00HC,"Above 10,000 (a)",6,30
3459,SSCLL,647,423,224,373,274,E07000181,E10000025,E12000008,38,"Below 1,000 (b)",13,10
3460,SSCMA,1617,713,904,420,1197,E06000022,E99999999,E12000009,00HA,"Above 1,000 (b)",11,10
3461,SSCMB,2689,249,2440,89,2600,E07000083,E10000013,E12000009,23,"Above 1,000 (b)",11,10
3462,SSCMN,47489,28873,18616,11066,36423,E07000083,E10000013,E12000009,23,"Above 20,000 (b)",5,30
3463,SSCMP,552,268,284,135,417,E06000022,E99999999,E12000009,00HA,"Below 1,000 (b)",13,10
3464,SSCOB,454,125,329,53,401,E07000079,E10000013,E12000009,23,"Below 1,000 (b)",13,10
3465,SSCOD,830,521,309,167,663,E06000054,E99999999,E12000009,00HY,"Below 1,000 (a)",12,10
3466,SSCOL,6439,5012,1427,2211,4228,W06000021,W99999999,W99999999,00PP,"Above 3,000 (b)",9,10
3467,SSCOR,5245,4775,470,3395,1850,E06000054,E99999999,E12000009,00HY,"Above 3,000 (b)",9,10
3468,SSCRA,512,350,162,149,363,E07000187,E10000027,E12000009,40,"Below 1,000 (b)",13,10
3469,SSCRD,2305,1934,371,1661,644,E06000054,E99999999,E12000009,00HY,"Above 1,000 (b)",11,10
3470,SSCRU,851,381,470,244,607,E06000054,E99999999,E12000009,00HY,"Below 1,000 (b)",13,10
3471,SSCSY,15853,13647,2206,4273,11580,E06000025,E99999999,E12000009,00HD,Large City,2,50
3472,SSDBK,2982,1693,1289,943,2039,E07000080,E10000013,E12000009,23,"Above 1,000 (b)",11,10
3473,SSDEV,10179,8272,1907,3802,6377,E06000054,E99999999,E12000009,00HY,"Above 10,000 (a)",6,30
3474,SSDID,716,309,407,13,703,E06000025,E99999999,E12000009,00HD,"Below 1,000 (b)",13,10
3475,SSDIT,508,345,163,195,313,E07000187,E10000027,E12000009,40,"Below 1,000 (b)",13,10
3476,SSDOW,18786,16254,2532,6795,11991,E06000025,E99999999,E12000009,00HD,Large City,2,50
3477,SSDSY,6976,5484,1492,2539,4437,E07000082,E10000013,E12000009,23,"Above 3,000 (a)",8,30
3478,SSDYK,657,347,310,238,419,E07000080,E10000013,E12000009,23,"Below 1,000 (b)",13,10
3479,SSEAS,10166,9475,691,7004,3162,E06000023,E99999999,E12000009,00HB,Large City,2,50
3480,SSEAV,16731,15927,804,7636,9095,E06000023,E99999999,E12000009,00HB,Large City,2,50
3481,SSEDI,1047,591,456,106,941,E07000188,E10000027,E12000009,40,"Above 1,000 (b)",11,10
3482,SSEVE,1200,1077,123,962,238,E07000187,E10000027,E12000009,40,"Above 1,000 (b)",11,10
3483,SSFAU,1039,174,865,82,957,E06000022,E99999999,E12000009,00HA,"Above 1,000 (b)",11,10
3484,SSFBE,550,285,265,79,471,E07000079,E10000013,E12000009,23,"Below 1,000 (a)",12,10
3485,SSFFD,1169,281,888,115,1054,E06000025,E99999999,E12000009,00HD,"Above 1,000 (b)",11,10
3486,SSFGN,3991,3645,346,3245,746,E07000180,E10000025,E12000008,38,"Above 3,000 (b)",9,10
3487,SSFIL,560,414,146,209,351,E07000181,E10000025,E12000008,38,"Below 1,000 (a)",12,10
3488,SSFIS,13874,13357,517,7457,6417,E06000025,E99999999,E12000009,00HD,Large City,2,50
3489,SSFLA,2433,2009,424,1553,880,E06000024,E99999999,E12000009,00HC,"Above 1,000 (b)",11,10
3490,SSFLT,20449,13189,7260,4828,15621,E06000025,E99999999,E12000009,00HD,Large City,2,50
3491,SSFRD,1897,1813,84,1422,475,E06000054,E99999999,E12000009,00HY,"Above 1,000 (b)",11,10
3492,SSFRO,13202,12648,554,6497,6705,E07000187,E10000027,E12000009,40,"Above 10,000 (a)",6,30
3493,SSFTM,1402,536,866,110,1292,E07000082,E10000013,E12000009,23,"Above 1,000 (b)",11,10
3494,SSGBW,1017,684,333,515,502,E06000054,E99999999,E12000009,00HY,"Above 1,000 (b)",11,10
3495,SSGLA,4924,4741,183,3620,1304,E07000187,E10000027,E12000009,40,"Above 3,000 (b)",9,10
3496,SSGLR,23986,17581,6405,5322,18664,E07000081,E10000013,E12000009,23,"Above 20,000 (a)",4,30
3497,SSGPR,682,261,421,61,621,E07000079,E10000013,E12000009,23,"Below 1,000 (b)",13,10
3498,SSHAW,1961,1622,339,869,1092,E06000054,E99999999,E12000009,00HY,"Above 1,000 (b)",11,10
3499,SSHEN,12470,10769,1701,5715,6755,E06000025,E99999999,E12000009,00HD,Large City,2,50
3500,SSHGH,4103,3846,257,3495,608,E07000180,E10000025,E12000008,38,"Above 3,000 (b)",9,10
3501,SSHIL,458,277,181,145,313,E06000054,E99999999,E12000009,00HY,"Below 1,000 (b)",13,10
3502,SSHPY,700,509,191,172,528,E07000080,E10000013,E12000009,23,"Below 1,000 (a)",12,10
3503,SSHUL,956,580,376,347,609,E06000054,E99999999,E12000009,00HY,"Below 1,000 (b)",13,10
3504,SSHWK,16623,12070,4553,4368,12255,E07000082,E10000013,E12000009,23,"Above 10,000 (b)",7,30
3505,SSHYW,14620,11941,2679,6696,7924,E06000054,E99999999,E12000009,00HY,"Above 10,000 (b)",7,30
3506,SSKEE,1843,728,1115,117,1726,E06000054,E99999999,E12000009,00HY,"Above 1,000 (b)",11,10
3507,SSKEL,325,166,159,45,280,E06000054,E99999999,E12000009,00HY,"Below 1,000 (b)",13,10
3508,SSKEY,8256,7376,880,4088,4168,E06000022,E99999999,E12000009,00HA,"Above 3,000 (b)",9,10
3509,SSKFD,673,516,157,375,298,E06000054,E99999999,E12000009,00HY,"Below 1,000 (b)",13,10
3510,SSKLY,1601,1394,207,217,1384,E06000054,E99999999,E12000009,00HY,"Above 1,000 (b)",11,10
3511,SSKMB,809,443,366,338,471,E06000054,E99999999,E12000009,00HY,"Below 1,000 (b)",13,10
3512,SSKMD,29543,21053,8490,8097,21446,E06000022,E99999999,E12000009,00HA,"Above 20,000 (a)",4,30
3513,SSKWD,28794,24049,4745,9053,19741,E06000025,E99999999,E12000009,00HD,Large City,2,50
3514,SSLAC,689,465,224,182,507,E06000054,E99999999,E12000009,00HY,"Below 1,000 (b)",13,10
3515,SSLAV,2250,1507,743,553,1697,E06000054,E99999999,E12000009,00HY,"Above 1,000 (b)",11,10
3516,SSLBK,1780,1147,633,527,1253,E07000080,E10000013,E12000009,23,"Above 1,000 (b)",11,10
3517,SSLDY,4712,4473,239,3424,1288,E07000080,E10000013,E12000009,23,"Above 3,000 (b)",9,10
3518,SSLHE,1711,1467,244,1014,697,E07000079,E10000013,E12000009,23,"Above 1,000 (a)",10,10
3519,SSLIM,1826,1039,787,347,1479,E06000022,E99999999,E12000009,00HA,"Above 1,000 (b)",11,10
3520,SSLKR,557,397,160,125,432,E06000054,E99999999,E12000009,00HY,"Below 1,000 (a)",12,10
3521,SSLON,3635,3192,443,851,2784,E06000024,E99999999,E12000009,00HC,"Above 3,000 (b)",9,10
3522,SSLOP,1477,738,739,182,1295,E07000080,E10000013,E12000009,23,"Above 1,000 (b)",11,10
3523,SSLTN,257,117,140,67,190,E07000082,E10000013,E12000009,23,"Below 1,000 (b)",13,10
3524,SSLUL,1267,632,635,352,915,E06000022,E99999999,E12000009,00HA,"Above 1,000 (b)",11,10
3525,SSMAI,655,177,478,151,504,E06000054,E99999999,E12000009,00HY,"Below 1,000 (b)",13,10
3526,SSMAL,4062,3116,946,1039,3023,E06000054,E99999999,E12000009,00HY,"Above 3,000 (b)",9,10
3527,SSMAR,1389,715,674,661,728,E06000022,E99999999,E12000009,00HA,"Above 1,000 (b)",11,10
3528,SSMBH,4351,4037,314,2868,1483,E06000054,E99999999,E12000009,00HY,"Above 3,000 (a)",8,30
3529,SSMEA,726,557,169,249,477,E07000187,E10000027,E12000009,40,"Below 1,000 (b)",13,10
3530,SSMEL,10758,8697,2061,4130,6628,E06000054,E99999999,E12000009,00HY,"Above 10,000 (b)",7,30
3531,SSMID,8489,7218,1271,4447,4042,E06000022,E99999999,E12000009,00HA,"Above 3,000 (a)",8,30
3532,SSMIN,838,509,329,354,484,E06000054,E99999999,E12000009,00HY,"Below 1,000 (b)",13,10
3533,SSMLS,1523,533,990,68,1455,E07000187,E10000027,E12000009,40,"Above 1,000 (b)",11,10
3534,SSMSD,584,131,453,55,529,E07000082,E10000013,E12000009,23,"Below 1,000 (b)",13,10
3535,SSMWH,572,154,418,26,546,E07000080,E10000013,E12000009,23,"Below 1,000 (b)",13,10
3536,SSNAH,2975,2313,662,1670,1305,E07000082,E10000013,E12000009,23,"Above 1,000 (a)",10,10
3537,SSNAI,8122,7692,430,4331,3791,E06000024,E99999999,E12000009,00HC,"Above 3,000 (b)",9,10
3538,SSNCN,621,243,378,99,522,E07000079,E10000013,E12000009,23,"Below 1,000 (b)",13,10
3539,SSNLH,1102,874,228,763,339,E07000079,E10000013,E12000009,23,"Above 1,000 (a)",10,10
3540,SSNOR,15873,15658,215,10450,5423,E06000023,E99999999,E12000009,00HB,Large City,2,50
3541,SSNRD,1066,704,362,458,608,E06000025,E99999999,E12000009,00HD,"Above 1,000 (b)",11,10
3542,SSNTB,2605,1315,1290,783,1822,E06000054,E99999999,E12000009,00HY,"Above 1,000 (a)",10,10
3543,SSNUN,770,506,264,409,361,E07000187,E10000027,E12000009,40,"Below 1,000 (b)",13,10
3544,SSNWT,2929,2581,348,2269,660,E07000080,E10000013,E12000009,23,"Above 1,000 (a)",10,10
3545,SSOAK,1239,580,659,356,883,E07000187,E10000027,E12000009,40,"Above 1,000 (b)",11,10
3546,SSOGB,349,214,135,179,170,E06000054,E99999999,E12000009,00HY,"Below 1,000 (a)",12,10
3547,SSOVY,779,387,392,231,548,E07000238,E10000034,E12000005,47,"Below 1,000 (b)",13,10
3548,SSPEW,2554,2005,549,1752,802,E06000054,E99999999,E12000009,00HY,"Above 1,000 (b)",11,10
3549,SSPIL,3475,2895,580,348,3127,E06000024,E99999999,E12000009,00HC,"Above 3,000 (b)",9,10
3550,SSPLG,2060,1331,729,425,1635,E06000025,E99999999,E12000009,00HD,"Above 1,000 (b)",11,10
3551,SSPLT,800,389,411,282,518,E07000187,E10000027,E12000009,40,"Below 1,000 (b)",13,10
3552,SSPOR,12337,10282,2055,5149,7188,E06000024,E99999999,E12000009,00HC,"Above 10,000 (a)",6,30
3553,SSPOU,1095,358,737,174,921,E06000054,E99999999,E12000009,00HY,"Above 1,000 (b)",11,10
3554,SSPRI,1392,594,798,339,1053,E07000187,E10000027,E12000009,40,"Above 1,000 (b)",11,10
3555,SSPTN,2418,1689,729,859,1559,E06000054,E99999999,E12000009,00HY,"Above 1,000 (b)",11,10
3556,SSPWK,1754,1273,481,915,839,E07000082,E10000013,E12000009,23,"Above 1,000 (b)",11,10
3557,SSRAD,6624,3610,3014,1914,4710,E06000022,E99999999,E12000009,00HA,"Above 3,000 (b)",9,10
3558,SSRAN,1580,1039,541,286,1294,E06000025,E99999999,E12000009,00HD,"Above 1,000 (b)",11,10
3559,SSRBY,968,798,170,715,253,E06000054,E99999999,E12000009,00HY,"Below 1,000 (b)",13,10
3560,SSRED,6892,6892,0,6063,829,E06000023,E99999999,E12000009,00HB,"Above 3,000 (a)",8,30
3561,SSRMN,334,130,204,65,269,E06000054,E99999999,E12000009,00HY,"Below 1,000 (b)",13,10
3562,SSSAL,1964,866,1098,509,1455,E07000080,E10000013,E12000009,23,"Above 1,000 (b)",11,10
3563,SSSBL,625,475,150,339,286,W06000021,W99999999,W99999999,00PP,"Below 1,000 (b)",13,10
3564,SSSEA,1356,534,822,101,1255,E06000054,E99999999,E12000009,00HY,"Above 1,000 (b)",11,10
3565,SSSEE,1214,514,700,259,955,E06000054,E99999999,E12000009,00HY,"Above 1,000 (b)",11,10
3566,SSSFD,2797,2226,571,1668,1129,E06000022,E99999999,E12000009,00HA,"Above 1,000 (b)",11,10
3567,SSSFV,1223,1029,194,901,322,E07000180,E10000025,E12000008,38,"Above 1,000 (b)",11,10
3568,SSSHC,2699,1606,1093,67,2632,E06000054,E99999999,E12000009,00HY,"Above 1,000 (b)",11,10
3569,SSSHE,1194,922,272,429,765,S12000029,S99999999,S99999999,00RF,"Above 1,000 (b)",11,10
3570,SSSHM,5274,5071,203,3811,1463,E07000187,E10000027,E12000009,40,"Above 3,000 (a)",8,30
3571,SSSHN,8259,4796,3463,767,7492,E07000079,E10000013,E12000009,23,"Above 3,000 (b)",9,10
3572,SSSHR,2485,2111,374,929,1556,E07000180,E10000025,E12000008,38,"Above 1,000 (b)",11,10
3573,SSSHT,1065,728,337,616,449,E06000054,E99999999,E12000009,00HY,"Above 1,000 (b)",11,10
3574,SSSOF,1950,1471,479,459,1491,E07000187,E10000027,E12000009,40,"Above 1,000 (b)",11,10
3575,SSSOU,18359,15237,3122,5913,12446,E06000023,E99999999,E12000009,00HB,Large City,2,50
3576,SSSRP,335,275,60,139,196,E07000079,E10000013,E12000009,23,"Below 1,000 (b)",13,10
3577,SSSSM,14826,11073,3753,3528,11298,E06000030,E99999999,E12000009,00HX,"Above 10,000 (a)",6,30
3578,SSSTD,18746,11658,7088,3863,14883,E07000082,E10000013,E12000009,23,"Above 10,000 (b)",7,30
3579,SSSTN,901,612,289,489,412,E07000080,E10000013,E12000009,23,"Below 1,000 (b)",13,10
3580,SSSTO,6684,6179,505,3587,3097,E06000024,E99999999,E12000009,00HC,"Above 3,000 (b)",9,10
3581,SSSTT,6472,6001,471,4385,2087,E07000189,E10000027,E12000009,40,"Above 3,000 (b)",9,10
3582,SSSUT,1025,461,564,304,721,E06000054,E99999999,E12000009,00HY,"Above 1,000 (b)",11,10
3583,SSSWD,2183,1483,700,1155,1028,E07000079,E10000013,E12000009,23,"Above 1,000 (a)",10,10
3584,SSSWN,34383,26170,8213,9405,24978,E06000030,E99999999,E12000009,00HX,"Above 20,000 (a)",4,30
3585,SSTBN,901,362,539,235,666,E07000080,E10000013,E12000009,23,"Below 1,000 (b)",13,10
3586,SSTEM,2765,1419,1346,619,2146,E06000022,E99999999,E12000009,00HA,"Above 1,000 (b)",11,10
3587,SSTHL,12015,11219,796,6979,5036,E06000054,E99999999,E12000009,00HY,"Above 10,000 (b)",7,30
3588,SSTHO,7539,5716,1823,3562,3977,E06000025,E99999999,E12000009,00HD,"Above 3,000 (b)",9,10
3589,SSTIM,3719,1804,1915,1106,2613,E06000022,E99999999,E12000009,00HA,"Above 3,000 (a)",8,30
3590,SSTRO,19051,15833,3218,6652,12399,E06000054,E99999999,E12000009,00HY,"Above 10,000 (a)",6,30
3591,SSTRY,766,249,517,152,614,E07000235,E10000034,E12000005,47,"Below 1,000 (b)",13,10
3592,SSTTY,3148,2927,221,2244,904,E06000054,E99999999,E12000009,00HY,"Above 3,000 (b)",9,10
3593,SSTWG,3564,1661,1903,262,3302,E07000081,E10000013,E12000009,23,"Above 3,000 (b)",9,10
3594,SSTXY,9341,6807,2534,3573,5768,E07000238,E10000034,E12000005,47,"Above 3,000 (b)",9,10
3595,SSUFN,686,384,302,326,360,E07000180,E10000025,E12000008,38,"Below 1,000 (b)",13,10
3596,SSULY,949,561,388,478,471,E07000082,E10000013,E12000009,23,"Below 1,000 (b)",13,10
3597,SSUPT,613,215,398,32,581,E07000189,E10000027,E12000009,40,"Below 1,000 (b)",13,10
3598,SSWAR,8996,8370,626,4303,4693,E06000054,E99999999,E12000009,00HY,"Above 3,000 (a)",8,30
3599,SSWBT,304,149,155,55,249,E06000054,E99999999,E12000009,00HY,"Below 1,000 (b)",13,10
3600,SSWCE,3786,3043,743,737,3049,E07000082,E10000013,E12000009,23,"Above 3,000 (b)",9,10
3601,SSWDH,604,387,217,200,404,E06000054,E99999999,E12000009,00HY,"Below 1,000 (b)",13,10
3602,SSWED,1451,903,548,694,757,E07000187,E10000027,E12000009,40,"Above 1,000 (b)",11,10
3603,SSWEL,7574,6055,1519,3390,4184,E07000187,E10000027,E12000009,40,"Above 3,000 (b)",9,10
3604,SSWES,11342,11285,57,8118,3224,E06000024,E99999999,E12000009,00HC,"Above 10,000 (a)",6,30
3605,SSWGN,4523,3977,546,2538,1985,E06000030,E99999999,E12000009,00HX,"Above 3,000 (b)",9,10
3606,SSWHE,2793,2567,226,2088,705,E07000079,E10000013,E12000009,23,"Above 1,000 (b)",11,10
3607,SSWHI,12866,12223,643,4639,8227,E06000022,E99999999,E12000009,00HA,"Above 10,000 (a)",6,30
3608,SSWHP,1080,555,525,221,859,E06000022,E99999999,E12000009,00HA,"Above 1,000 (b)",11,10
3609,SSWIB,10705,5399,5306,2246,8459,E06000025,E99999999,E12000009,00HD,Large City,2,50
3610,SSWIN,2260,1712,548,1189,1071,E07000188,E10000027,E12000009,40,"Above 1,000 (b)",11,10
3611,SSWNB,4765,909,3856,588,4177,E06000030,E99999999,E12000009,00HX,"Above 3,000 (b)",9,10
3612,SSWOB,6378,6109,269,3092,3286,E06000054,E99999999,E12000009,00HY,"Above 3,000 (b)",9,10
3613,SSWOR,17710,15611,2099,6798,10912,E06000024,E99999999,E12000009,00HC,"Above 10,000 (b)",7,30
3614,SSWOS,741,347,394,147,594,E07000080,E10000013,E12000009,23,"Below 1,000 (b)",13,10
3615,SSWOT,9581,9399,182,5428,4153,E06000023,E99999999,E12000009,00HB,"Above 3,000 (b)",9,10
3616,SSWRH,627,157,470,36,591,E07000079,E10000013,E12000009,23,"Below 1,000 (b)",13,10
3617,SSWRI,1316,1150,166,1005,311,E06000024,E99999999,E12000009,00HC,"Above 1,000 (b)",11,10
3618,SSWSM,17606,16171,1435,6743,10863,E06000024,E99999999,E12000009,00HC,"Above 10,000 (b)",7,30
3619,SSWTC,3191,2202,989,555,2636,E07000080,E10000013,E12000009,23,"Above 3,000 (b)",9,10
3620,SSWTN,301,202,99,117,184,E07000079,E10000013,E12000009,23,"Below 1,000 (b)",13,10
3621,SSWUE,4196,3146,1050,2436,1760,E06000025,E99999999,E12000009,00HD,"Above 3,000 (b)",9,10
3622,SSWWR,1188,729,459,579,609,E06000025,E99999999,E12000009,00HD,"Above 1,000 (b)",11,10
3623,SSWWS,8171,7127,1044,5000,3171,E06000054,E99999999,E12000009,00HY,"Above 3,000 (b)",9,10
3624,SSWYL,498,235,263,198,300,E06000054,E99999999,E12000009,00HY,"Below 1,000 (b)",13,10
3625,SSYAT,5319,3818,1501,814,4505,E06000024,E99999999,E12000009,00HC,"Above 3,000 (b)",9,10
3626,STABTAN,1216,990,226,475,741,E07000093,E10000014,E12000008,24,"Above 1,000 (b)",11,10
3627,STABTSY,729,401,328,248,481,E07000052,E10000009,E12000009,19,"Below 1,000 (b)",13,10
3628,STALDBY,1388,1096,292,796,592,E06000054,E99999999,E12000009,00HY,"Above 1,000 (a)",10,10
3629,STALSFD,3289,2973,316,2175,1114,E07000094,E10000014,E12000008,24,"Above 3,000 (b)",9,10
3630,STAMSBY,5109,5041,68,2167,2942,E06000054,E99999999,E12000009,00HY,"Above 3,000 (b)",9,10
3631,STANDVR,21877,15401,6476,5748,16129,E07000093,E10000014,E12000008,24,"Above 20,000 (a)",4,30
3632,STASHST,1509,1141,368,642,867,E07000091,E10000014,E12000008,24,"Above 1,000 (b)",11,10
3633,STBBSTK,1163,617,546,506,657,E07000052,E10000009,E12000009,19,"Above 1,000 (b)",11,10
3634,STBDSTN,16576,11113,5463,3384,13192,E06000029,E99999999,E12000009,00HP,Small City,3,50
3635,STBDWSR,1066,397,669,308,758,E07000189,E10000027,E12000009,40,"Above 1,000 (b)",11,10
3636,STBERER,1380,772,608,629,751,E07000050,E10000009,E12000009,19,"Above 1,000 (b)",11,10
3637,STBEULI,599,267,332,131,468,E07000091,E10000014,E12000008,24,"Below 1,000 (b)",13,10
3638,STBINAB,2644,1592,1052,894,1750,E07000051,E10000009,E12000009,19,"Above 1,000 (b)",11,10
3639,STBISHW,5330,3502,1828,2187,3143,E07000094,E10000014,E12000008,24,"Above 3,000 (a)",8,30
3640,STBLFRD,1556,1529,27,687,869,E06000054,E99999999,E12000009,00HY,"Above 1,000 (b)",11,10
3641,STBLNFD,7809,6117,1692,3744,4065,E07000050,E10000009,E12000009,19,"Above 3,000 (b)",9,10
3642,STBMSTR,1811,1702,109,1411,400,E07000052,E10000009,E12000009,19,"Above 1,000 (b)",11,10
3643,STBNMTH,10343,10343,0,6512,3831,E06000028,E99999999,E12000009,00HN,Small City,3,50
3644,STBORTN,1139,890,249,525,614,E06000054,E99999999,E12000009,00HY,"Above 1,000 (b)",11,10
3645,STBOSMB,17199,14723,2476,10088,7111,E06000028,E99999999,E12000009,00HN,Small City,3,50
3646,STBOTLY,9447,6253,3194,1303,8144,E07000094,E10000014,E12000008,24,"Above 3,000 (b)",9,10
3647,STBRDCK,684,304,380,194,490,E06000054,E99999999,E12000009,00HY,"Below 1,000 (b)",13,10
3648,STBRDPT,8022,7360,662,4588,3434,E07000052,E10000009,E12000009,19,"Above 3,000 (a)",8,30
3649,STBRFLD,1429,630,799,216,1213,E07000094,E10000014,E12000008,24,"Above 1,000 (b)",11,10
3650,STBRGTN,542,459,83,388,154,E07000093,E10000014,E12000008,24,"Below 1,000 (b)",13,10
3651,STBRMDN,685,195,490,106,579,E07000094,E10000014,E12000008,24,"Below 1,000 (b)",13,10
3652,STBRNGR,2267,1764,503,1482,785,E07000048,E10000009,E12000009,19,"Above 1,000 (b)",11,10
3653,STBROCK,1779,1567,212,1169,610,E07000091,E10000014,E12000008,24,"Above 1,000 (b)",11,10
3654,STBSETT,8671,8478,193,3916,4755,E07000093,E10000014,E12000008,24,"Above 3,000 (b)",9,10
3655,STBUCKN,499,290,209,179,320,E07000050,E10000009,E12000009,19,"Below 1,000 (b)",13,10
3656,STBURLY,750,604,146,235,515,E07000091,E10000014,E12000008,24,"Below 1,000 (b)",13,10
3657,STBURSN,7791,6774,1017,2444,5347,E07000087,E10000014,E12000008,24,Small City,3,50
3658,STCADNM,1803,1060,743,511,1292,E07000091,E10000014,E12000008,24,"Above 1,000 (b)",11,10
3659,STCANCL,3976,3291,685,1732,2244,E06000029,E99999999,E12000009,00HP,"Above 3,000 (b)",9,10
3660,STCERNA,702,422,280,399,303,E07000052,E10000009,E12000009,19,"Below 1,000 (b)",13,10
3661,STCFORD,14879,12256,2623,4906,9973,E07000094,E10000014,E12000008,24,"Above 10,000 (b)",7,30
3662,STCHBTN,830,639,191,417,413,E07000093,E10000014,E12000008,24,"Below 1,000 (a)",12,10
3663,STCHLDO,1737,1269,468,242,1495,E07000050,E10000009,E12000009,19,"Above 1,000 (b)",11,10
3664,STCHOLD,525,183,342,76,449,E06000054,E99999999,E12000009,00HY,"Below 1,000 (b)",13,10
3665,STCHRCH,15659,12613,3046,3903,11756,E06000028,E99999999,E12000009,00HN,Small City,3,50
3666,STCHSTN,246,175,71,47,199,E06000054,E99999999,E12000009,00HY,"Below 1,000 (b)",13,10
3667,STCOLDC,726,409,317,340,386,E06000054,E99999999,E12000009,00HY,"Below 1,000 (a)",12,10
3668,STCOOMB,547,261,286,128,419,E06000054,E99999999,E12000009,00HY,"Below 1,000 (b)",13,10
3669,STCORFC,1081,681,400,547,534,E07000051,E10000009,E12000009,19,"Above 1,000 (b)",11,10
3670,STCRANB,624,346,278,285,339,E07000049,E10000009,E12000009,19,"Below 1,000 (b)",13,10
3671,STDONHD,905,524,381,122,783,E06000054,E99999999,E12000009,00HY,"Below 1,000 (b)",13,10
3672,STDORCH,12057,9236,2821,6001,6056,E07000052,E10000009,E12000009,19,"Above 10,000 (a)",6,30
3673,STDOWTN,2952,2060,892,845,2107,E06000054,E99999999,E12000009,00HY,"Above 1,000 (b)",11,10
3674,STDROXF,1160,564,596,329,831,E07000094,E10000014,E12000008,24,"Above 1,000 (b)",11,10
3675,STDURLY,751,556,195,174,577,E07000094,E10000014,E12000008,24,"Below 1,000 (b)",13,10
3676,STDURRW,3114,2598,516,1919,1195,E06000054,E99999999,E12000009,00HY,"Above 3,000 (b)",9,10
3677,STEARLD,892,676,216,216,676,E06000054,E99999999,E12000009,00HY,"Below 1,000 (b)",13,10
3678,STEASTE,519,237,282,110,409,E07000091,E10000014,E12000008,24,"Below 1,000 (b)",13,10
3679,STEASTK,674,331,343,206,468,E06000054,E99999999,E12000009,00HY,"Below 1,000 (b)",13,10
3680,STEASTL,13920,12688,1232,6810,7110,E07000094,E10000014,E12000008,24,"Above 10,000 (b)",7,30
3681,STEASTS,949,439,510,226,723,E07000050,E10000009,E12000009,19,"Below 1,000 (b)",13,10
3682,STFAIRO,6637,5649,988,2318,4319,E07000094,E10000014,E12000008,24,"Above 3,000 (b)",9,10
3683,STFARLY,506,250,256,123,383,E06000054,E99999999,E12000009,00HY,"Below 1,000 (a)",12,10
3684,STFAWLY,6429,5373,1056,2453,3976,E07000091,E10000014,E12000008,24,"Above 3,000 (b)",9,10
3685,STFERND,13586,10047,3539,3463,10123,E07000048,E10000009,E12000009,19,Small City,3,50
3686,STFONTM,1198,467,731,262,936,E07000050,E10000009,E12000009,19,"Above 1,000 (b)",11,10
3687,STFORDB,5550,3092,2458,2181,3369,E07000049,E10000009,E12000009,19,"Above 3,000 (b)",9,10
3688,STFOVNT,641,387,254,145,496,E06000054,E99999999,E12000009,00HY,"Below 1,000 (b)",13,10
3689,STGILGM,5727,5421,306,3210,2517,E07000050,E10000009,E12000009,19,"Above 3,000 (b)",9,10
3690,STGRATY,509,348,161,213,296,E07000093,E10000014,E12000008,24,"Below 1,000 (b)",13,10
3691,STHAMBL,5867,5043,824,2082,3785,E07000087,E10000014,E12000008,24,"Above 3,000 (b)",9,10
3692,STHANLY,812,477,335,433,379,E06000054,E99999999,E12000009,00HY,"Below 1,000 (b)",13,10
3693,STHAZEB,1010,442,568,241,769,E07000050,E10000009,E12000009,19,"Above 1,000 (b)",11,10
3694,STHICLF,10975,8891,2084,3001,7974,E07000048,E10000009,E12000009,19,Small City,3,50
3695,STHINDN,492,378,114,268,224,E06000054,E99999999,E12000009,00HY,"Below 1,000 (b)",13,10
3696,STHMPTN,15596,15573,23,6216,9380,E07000086,E10000014,E12000008,24,Small City,3,50
3697,STHRSLY,586,280,306,212,374,E07000094,E10000014,E12000008,24,"Below 1,000 (b)",13,10
3698,STHRSTK,6818,3811,3007,1595,5223,E07000094,E10000014,E12000008,24,"Above 3,000 (b)",9,10
3699,STHRSTT,454,325,129,246,208,E07000084,E10000014,E12000008,24,"Below 1,000 (b)",13,10
3700,STHTHDN,716,130,586,92,624,E06000054,E99999999,E12000009,00HY,"Below 1,000 (b)",13,10
3701,STHYTHE,9621,7462,2159,3518,6103,E07000091,E10000014,E12000008,24,"Above 3,000 (b)",9,10
3702,STICHAB,696,471,225,241,455,E07000094,E10000014,E12000008,24,"Below 1,000 (b)",13,10
3703,STIDSTN,1713,1053,660,533,1180,E06000054,E99999999,E12000009,00HY,"Above 1,000 (b)",11,10
3704,STKINGS,838,634,204,482,356,E07000093,E10000014,E12000008,24,"Below 1,000 (a)",12,10
3705,STLCKLY,1230,446,784,163,1067,E07000093,E10000014,E12000008,24,"Above 1,000 (b)",11,10
3706,STLGSHL,2411,2204,207,1845,566,E06000054,E99999999,E12000009,00HY,"Above 1,000 (a)",10,10
3707,STLNKHT,307,211,96,142,165,E06000054,E99999999,E12000009,00HY,"Below 1,000 (b)",13,10
3708,STLOCKH,17496,12939,4557,5439,12057,E07000094,E10000014,E12000008,24,"Above 10,000 (b)",7,30
3709,STLONGB,723,274,449,157,566,E07000052,E10000009,E12000009,19,"Below 1,000 (b)",13,10
3710,STLONGP,652,318,334,180,472,E07000084,E10000014,E12000008,24,"Below 1,000 (b)",13,10
3711,STLYMTN,9251,8480,771,4930,4321,E07000091,E10000014,E12000008,24,"Above 3,000 (b)",9,10
3712,STLYNST,1728,1572,156,1362,366,E07000091,E10000014,E12000008,24,"Above 1,000 (a)",10,10
3713,STLYTMN,6637,2132,4505,288,6349,E06000029,E99999999,E12000009,00HP,Small City,3,50
3714,STMARNL,1161,978,183,695,466,E07000050,E10000009,E12000009,19,"Above 1,000 (b)",11,10
3715,STMARTN,1041,411,630,126,915,E07000052,E10000009,E12000009,19,"Above 1,000 (b)",11,10
3716,STMARTX,268,178,90,143,125,E06000054,E99999999,E12000009,00HY,"Below 1,000 (b)",13,10
3717,STMCHDV,746,328,418,215,531,E07000094,E10000014,E12000008,24,"Below 1,000 (b)",13,10
3718,STMDNTN,1343,723,620,591,752,E07000052,E10000009,E12000009,19,"Above 1,000 (a)",10,10
3719,STMERE,1586,1501,85,1346,240,E06000054,E99999999,E12000009,00HY,"Above 1,000 (b)",11,10
3720,STMIDWD,457,245,212,123,334,E06000054,E99999999,E12000009,00HY,"Below 1,000 (b)",13,10
3721,STMILAB,1230,282,948,66,1164,E07000050,E10000009,E12000009,19,"Above 1,000 (b)",11,10
3722,STMILOS,3731,2787,944,2162,1569,E07000091,E10000014,E12000008,24,"Above 3,000 (a)",8,30
3723,STMILSA,917,518,399,435,482,E07000050,E10000009,E12000009,19,"Below 1,000 (a)",12,10
3724,STMORDN,857,179,678,77,780,E07000050,E10000009,E12000009,19,"Below 1,000 (b)",13,10
3725,STMRHLL,19028,17608,1420,5444,13584,E07000086,E10000014,E12000008,24,Small City,3,50
3726,STNETBY,667,270,397,158,509,E07000052,E10000009,E12000009,19,"Below 1,000 (b)",13,10
3727,STNETHR,1103,840,263,592,511,E06000054,E99999999,E12000009,00HY,"Above 1,000 (b)",11,10
3728,STNEWMN,14658,11673,2985,5423,9235,E07000048,E10000009,E12000009,19,Small City,3,50
3729,STNTHBN,18862,12129,6733,4297,14565,E06000028,E99999999,E12000009,00HN,Small City,3,50
3730,STOWSBY,567,305,262,168,399,E07000094,E10000014,E12000008,24,"Below 1,000 (a)",12,10
3731,STOXNWD,230,52,178,31,199,E06000054,E99999999,E12000009,00HY,"Below 1,000 (b)",13,10
3732,STPIDTH,687,268,419,178,509,E07000052,E10000009,E12000009,19,"Below 1,000 (b)",13,10
3733,STPOOLE,16278,11746,4532,5866,10412,E06000029,E99999999,E12000009,00HP,Small City,3,50
3734,STPORTL,6112,5140,972,1840,4272,E07000053,E10000009,E12000009,19,"Above 3,000 (b)",9,10
3735,STPRKST,21975,17334,4641,7987,13988,E06000029,E99999999,E12000009,00HP,Small City,3,50
3736,STPRSTN,3940,3350,590,2061,1879,E07000052,E10000009,E12000009,19,"Above 3,000 (b)",9,10
3737,STPUDTN,996,613,383,538,458,E07000052,E10000009,E12000009,19,"Below 1,000 (b)",13,10
3738,STPWRST,654,182,472,89,565,E07000052,E10000009,E12000009,19,"Below 1,000 (b)",13,10
3739,STRINGW,9819,6787,3032,3285,6534,E07000049,E10000009,E12000009,19,Small City,3,50
3740,STROCKB,528,208,320,92,436,E07000091,E10000014,E12000008,24,"Below 1,000 (b)",13,10
3741,STROMSY,9526,8308,1218,4665,4861,E07000093,E10000014,E12000008,24,"Above 3,000 (a)",8,30
3742,STROPLY,772,595,177,337,435,E07000085,E10000014,E12000008,24,"Below 1,000 (b)",13,10
3743,STRWNMS,10774,7156,3618,1747,9027,E07000093,E10000014,E12000008,24,"Above 10,000 (a)",6,30
3744,STSALIS,22517,16613,5904,7248,15269,E06000054,E99999999,E12000009,00HY,"Above 20,000 (a)",4,30
3745,STSHABY,5322,4558,764,3513,1809,E06000054,E99999999,E12000009,00HY,"Above 3,000 (b)",9,10
3746,STSHRLY,22793,22030,763,9697,13096,E07000091,E10000014,E12000008,24,"Above 20,000 (b)",5,30
3747,STSHRTN,1244,881,363,738,506,E06000054,E99999999,E12000009,00HY,"Above 1,000 (b)",11,10
3748,STSOTON,18150,16891,1259,8142,10008,E07000091,E10000014,E12000008,24,"Above 10,000 (b)",7,30
3749,STSPSLT,553,309,244,63,490,E07000094,E10000014,E12000008,24,"Below 1,000 (a)",12,10
3750,STSSCOT,1264,618,646,503,761,E07000094,E10000014,E12000008,24,"Above 1,000 (b)",11,10
3751,STSTHBN,13046,12753,293,7792,5254,E06000028,E99999999,E12000009,00HN,Small City,3,50
3752,STSTMBN,693,501,192,321,372,E07000084,E10000014,E12000008,24,"Below 1,000 (b)",13,10
3753,STSTOKB,721,547,174,425,296,E07000093,E10000014,E12000008,24,"Below 1,000 (b)",13,10
3754,STSTPFD,684,278,406,88,596,E06000054,E99999999,E12000009,00HY,"Below 1,000 (b)",13,10
3755,STSTUDL,390,373,17,199,191,E07000051,E10000009,E12000009,19,"Below 1,000 (b)",13,10
3756,STSTURM,1148,735,413,611,537,E07000050,E10000009,E12000009,19,"Above 1,000 (b)",11,10
3757,STSTURN,2475,2138,337,1632,843,E07000050,E10000009,E12000009,19,"Above 1,000 (a)",10,10
3758,STSWANG,6275,6084,191,4487,1788,E07000051,E10000009,E12000009,19,"Above 3,000 (a)",8,30
3759,STSWAY,1909,1423,486,1120,789,E07000091,E10000014,E12000008,24,"Above 1,000 (b)",11,10
3760,STTDWTH,3427,2942,485,802,2625,E06000054,E99999999,E12000009,00HY,"Above 3,000 (b)",9,10
3761,STTEFFT,686,302,384,99,587,E06000054,E99999999,E12000009,00HY,"Below 1,000 (b)",13,10
3762,STTISBY,1665,1341,324,1210,455,E06000054,E99999999,E12000009,00HY,"Above 1,000 (b)",11,10
3763,STTOTTN,16345,10855,5490,3592,12753,E07000091,E10000014,E12000008,24,"Above 10,000 (a)",6,30
3764,STTRTHN,1237,147,1090,85,1152,E06000054,E99999999,E12000009,00HY,"Above 1,000 (b)",11,10
3765,STTWYFD,3947,1659,2288,785,3162,E07000094,E10000014,E12000008,24,"Above 3,000 (b)",9,10
3766,STUPAVN,850,504,346,319,531,E06000054,E99999999,E12000009,00HY,"Below 1,000 (b)",13,10
3767,STUPWEY,4237,3630,607,2341,1896,E07000052,E10000009,E12000009,19,"Above 3,000 (b)",9,10
3768,STVERWD,7107,5707,1400,3308,3799,E07000049,E10000009,E12000009,19,Small City,3,50
3769,STWALOP,1016,647,369,212,804,E07000093,E10000014,E12000008,24,"Above 1,000 (b)",11,10
3770,STWARHM,4889,3750,1139,1817,3072,E07000051,E10000009,E12000009,19,"Above 3,000 (b)",9,10
3771,STWESTL,526,407,119,315,211,E07000051,E10000009,E12000009,19,"Below 1,000 (a)",12,10
3772,STWESTW,1718,1392,326,756,962,E06000054,E99999999,E12000009,00HY,"Above 1,000 (b)",11,10
3773,STWEYHL,1804,1036,768,441,1363,E07000093,E10000014,E12000008,24,"Above 1,000 (b)",11,10
3774,STWEYMH,21338,13979,7359,6224,15114,E07000052,E10000009,E12000009,19,"Above 20,000 (b)",5,30
3775,STWHPSH,924,576,348,478,446,E06000054,E99999999,E12000009,00HY,"Below 1,000 (b)",13,10
3776,STWIMBN,10717,6217,4500,4057,6660,E06000029,E99999999,E12000009,00HP,Small City,3,50
3777,STWINCH,16826,13712,3114,7241,9585,E07000094,E10000014,E12000008,24,"Above 10,000 (b)",7,30
3778,STWINSL,1169,764,405,574,595,E06000054,E99999999,E12000009,00HY,"Above 1,000 (b)",11,10
3779,STWINTN,23071,18628,4443,8269,14802,E06000028,E99999999,E12000009,00HN,Small City,3,50
3780,STWITCH,1099,289,810,47,1052,E07000050,E10000009,E12000009,19,"Above 1,000 (b)",11,10
3781,STWLSTN,17761,17007,754,7151,10610,E06000045,E99999999,E12000008,00MS,Small City,3,50
3782,STWLTON,3767,2191,1576,1474,2293,E06000054,E99999999,E12000009,00HY,"Above 3,000 (b)",9,10
3783,STWRMWL,2637,236,2401,169,2468,E07000052,E10000009,E12000009,19,"Above 1,000 (b)",11,10
3784,STWRTHM,631,290,341,136,495,E07000051,E10000009,E12000009,19,"Below 1,000 (b)",13,10
3785,STWSTBN,16334,14845,1489,8846,7488,E06000028,E99999999,E12000009,00HN,Small City,3,50
3786,SWAA,14198,8883,5315,3829,10369,W06000016,W99999999,W99999999,00PF,"Above 10,000 (b)",7,30
3787,SWAAI,1584,1137,447,895,689,W06000008,W99999999,W99999999,00NQ,"Above 1,000 (a)",10,10
3788,SWAAV,1459,748,711,436,1023,W06000023,W99999999,W99999999,00NN,"Above 1,000 (b)",11,10
3789,SWAAZ,7977,6057,1920,3046,4931,W06000013,W99999999,W99999999,00PB,"Above 3,000 (b)",9,10
3790,SWABD,7424,5511,1913,4118,3306,W06000018,W99999999,W99999999,00PK,"Above 3,000 (b)",9,10
3791,SWABT,4205,2698,1507,1869,2336,W06000018,W99999999,W99999999,00PK,"Above 3,000 (b)",9,10
3792,SWADW,6829,4828,2001,2559,4270,W06000010,W99999999,W99999999,00NU,"Above 3,000 (b)",9,10
3793,SWAEN,1112,324,788,221,891,W06000008,W99999999,W99999999,00NQ,"Above 1,000 (a)",10,10
3794,SWAG,8157,7319,838,3880,4277,W06000021,W99999999,W99999999,00PP,"Above 3,000 (a)",8,30
3795,SWAGL,102,38,64,6,96,W06000009,W99999999,W99999999,00NS,"Below 1,000 (a)",12,10
3796,SWAPO,1766,1096,670,665,1101,W06000008,W99999999,W99999999,00NQ,"Above 1,000 (b)",11,10
3797,SWAVY,5013,2428,2585,1041,3972,W06000012,W99999999,W99999999,00NZ,"Above 3,000 (a)",8,30
3798,SWBIG,13564,12047,1517,4739,8825,W06000018,W99999999,W99999999,00PK,"Above 10,000 (b)",7,30
3799,SWBII,3024,2922,102,2558,466,W06000021,W99999999,W99999999,00PP,"Above 3,000 (b)",9,10
3800,SWBIK,3061,3039,22,1946,1115,W06000019,W99999999,W99999999,00PL,"Above 3,000 (a)",8,30
3801,SWBJY,504,215,289,109,395,W06000014,W99999999,W99999999,00PD,"Below 1,000 (b)",13,10
3802,SWBNB,4921,4196,725,3269,1652,W06000023,W99999999,W99999999,00NN,"Above 3,000 (b)",9,10
3803,SWBNP,22058,15545,6513,5203,16855,W06000014,W99999999,W99999999,00PD,"Above 20,000 (b)",5,30
3804,SWBPG,4445,4133,312,2302,2143,W06000012,W99999999,W99999999,00NZ,"Above 3,000 (b)",9,10
3805,SWBSE,5537,4839,698,3326,2211,W06000021,W99999999,W99999999,00PP,"Above 3,000 (b)",9,10
3806,SWBUD,4430,3638,792,2802,1628,W06000010,W99999999,W99999999,00NU,"Above 3,000 (b)",9,10
3807,SWCAA,6314,5656,658,1417,4897,W06000021,W99999999,W99999999,00PP,"Above 3,000 (b)",9,10
3808,SWCAB,15723,12351,3372,4091,11632,W06000015,W99999999,W99999999,00PT,Small City,3,50
3809,SWCFATE,23832,15369,8463,1990,21842,W06000015,W99999999,W99999999,00PT,Small City,3,50
3810,SWCFK,22603,17791,4812,5947,16656,W06000014,W99999999,W99999999,00PD,"Above 20,000 (b)",5,30
3811,SWCG,3984,3101,883,1915,2069,W06000008,W99999999,W99999999,00NQ,"Above 3,000 (a)",8,30
3812,SWCIT,7053,5564,1489,3966,3087,W06000021,W99999999,W99999999,00PP,"Above 3,000 (b)",9,10
3813,SWCJ,8793,7214,1579,3433,5360,E06000025,E99999999,E12000009,00HD,"Above 3,000 (b)",9,10
3814,SWCJW,5684,4843,841,2761,2923,W06000012,W99999999,W99999999,00NZ,"Above 3,000 (b)",9,10
3815,SWCNE,3481,2177,1304,1662,1819,W06000014,W99999999,W99999999,00PD,"Above 3,000 (b)",9,10
3816,SWCOO,1887,1502,385,1084,803,W06000021,W99999999,W99999999,00PP,"Above 1,000 (b)",11,10
3817,SWCRS,21842,16124,5718,3849,17993,W06000021,W99999999,W99999999,00PP,"Above 20,000 (b)",5,30
3818,SWCT,9759,7611,2148,4280,5479,W06000010,W99999999,W99999999,00NU,"Above 3,000 (b)",9,10
3819,SWCUV,12841,11820,1021,6874,5967,W06000015,W99999999,W99999999,00PT,Small City,3,50
3820,SWCWN,506,173,333,75,431,W06000008,W99999999,W99999999,00NQ,"Below 1,000 (b)",13,10
3821,SWCXX,6122,2636,3486,886,5236,W06000010,W99999999,W99999999,00NU,"Above 3,000 (b)",9,10
3822,SWCYX,4310,2172,2138,622,3688,W06000013,W99999999,W99999999,00PB,"Above 3,000 (b)",9,10
3823,SWDAQ,668,189,479,19,649,W06000009,W99999999,W99999999,00NS,"Below 1,000 (b)",13,10
3824,SWDCP,571,492,79,322,249,W06000009,W99999999,W99999999,00NS,"Below 1,000 (b)",13,10
3825,SWDPW,3875,3555,320,2785,1090,W06000014,W99999999,W99999999,00PD,"Above 3,000 (b)",9,10
3826,SWDRW,632,185,447,62,570,W06000010,W99999999,W99999999,00NU,"Below 1,000 (b)",13,10
3827,SWDWQ,368,195,173,110,258,W06000021,W99999999,W99999999,00PP,"Below 1,000 (b)",13,10
3828,SWEBY,7743,6412,1331,3961,3782,W06000019,W99999999,W99999999,00PL,"Above 3,000 (a)",8,30
3829,SWFBX,4331,3093,1238,2022,2309,W06000016,W99999999,W99999999,00PF,"Above 3,000 (b)",9,10
3830,SWFBZ,393,224,169,35,358,W06000010,W99999999,W99999999,00NU,"Below 1,000 (b)",13,10
3831,SWFCJ,3362,2933,429,1830,1532,W06000009,W99999999,W99999999,00NS,"Above 3,000 (b)",9,10
3832,SWGAR,2547,1444,1103,1023,1524,W06000021,W99999999,W99999999,00PP,"Above 1,000 (b)",11,10
3833,SWGBG,2879,2464,415,1676,1203,W06000016,W99999999,W99999999,00PF,"Above 1,000 (b)",11,10
3834,SWGBY,10544,7911,2633,4370,6174,W06000011,W99999999,W99999999,00NX,Small City,3,50
3835,SWGC,5724,3960,1764,2202,3522,W06000011,W99999999,W99999999,00NX,"Above 3,000 (b)",9,10
3836,SWGLN,5652,3764,1888,1621,4031,W06000012,W99999999,W99999999,00NZ,"Above 3,000 (b)",9,10
3837,SWGWN,290,56,234,15,275,W06000010,W99999999,W99999999,00NU,"Below 1,000 (b)",13,10
3838,SWGWR,1046,300,746,187,859,W06000011,W99999999,W99999999,00NX,"Above 1,000 (a)",10,10
3839,SWHJL,4071,2412,1659,1439,2632,W06000016,W99999999,W99999999,00PF,"Above 3,000 (b)",9,10
3840,SWHV,8209,7240,969,4094,4115,W06000009,W99999999,W99999999,00NS,"Above 3,000 (a)",8,30
3841,SWHXM,7055,5582,1473,2536,4519,W06000018,W99999999,W99999999,00PK,"Above 3,000 (b)",9,10
3842,SWJOH,1867,996,871,729,1138,W06000009,W99999999,W99999999,00NS,"Above 1,000 (b)",11,10
3843,SWKGH,8222,6696,1526,3303,4919,W06000013,W99999999,W99999999,00PB,"Above 3,000 (b)",9,10
3844,SWKW,1782,1475,307,1174,608,W06000010,W99999999,W99999999,00NU,"Above 1,000 (b)",11,10
3845,SWLAK,2091,1613,478,1104,987,W06000010,W99999999,W99999999,00NU,"Above 1,000 (b)",11,10
3846,SWLAS,686,551,135,445,241,W06000010,W99999999,W99999999,00NU,"Below 1,000 (b)",13,10
3847,SWLCA,440,174,266,79,361,W06000021,W99999999,W99999999,00PP,"Below 1,000 (b)",13,10
3848,SWLCY,670,343,327,112,558,W06000021,W99999999,W99999999,00PP,"Below 1,000 (b)",13,10
3849,SWLDR,747,302,445,65,682,W06000010,W99999999,W99999999,00NU,"Below 1,000 (b)",13,10
3850,SWLDV,1131,610,521,506,625,W06000009,W99999999,W99999999,00NS,"Above 1,000 (b)",11,10
3851,SWLGC,867,333,534,163,704,W06000008,W99999999,W99999999,00NQ,"Below 1,000 (b)",13,10
3852,SWLHY,1209,647,562,476,733,W06000009,W99999999,W99999999,00NS,"Above 1,000 (b)",11,10
3853,SWLJ,17782,13773,4009,6994,10788,W06000010,W99999999,W99999999,00NU,"Above 10,000 (b)",7,30
3854,SWLJV,480,174,306,91,389,W06000010,W99999999,W99999999,00NU,"Below 1,000 (b)",13,10
3855,SWLJZ,15905,15556,349,6178,9727,W06000015,W99999999,W99999999,00PT,Small City,3,50
3856,SWLKB,2222,1573,649,1203,1019,W06000010,W99999999,W99999999,00NU,"Above 1,000 (a)",10,10
3857,SWLKD,1404,1020,384,884,520,W06000023,W99999999,W99999999,00NN,"Above 1,000 (b)",11,10
3858,SWLKX,631,144,487,21,610,W06000021,W99999999,W99999999,00PP,"Below 1,000 (b)",13,10
3859,SWLKY,1004,447,557,271,733,W06000010,W99999999,W99999999,00NU,"Above 1,000 (b)",11,10
3860,SWLLD,12851,10625,2226,5231,7620,W06000015,W99999999,W99999999,00PT,Small City,3,50
3861,SWLLF,330,97,233,47,283,W06000021,W99999999,W99999999,00PP,"Below 1,000 (b)",13,10
3862,SWLLG,6407,3500,2907,1624,4783,W06000010,W99999999,W99999999,00NU,"Above 3,000 (a)",8,30
3863,SWLLM,1052,748,304,123,929,W06000010,W99999999,W99999999,00NU,"Above 1,000 (b)",11,10
3864,SWLLO,9993,6480,3513,2537,7456,W06000014,W99999999,W99999999,00PD,"Above 3,000 (b)",9,10
3865,SWLLP,1038,419,619,278,760,W06000008,W99999999,W99999999,00NQ,"Above 1,000 (b)",11,10
3866,SWLLR,4919,4042,877,2891,2028,W06000014,W99999999,W99999999,00PD,"Above 3,000 (a)",8,30
3867,SWLLU,1202,800,402,557,645,W06000010,W99999999,W99999999,00NU,"Above 1,000 (b)",11,10
3868,SWLLW,1431,570,861,337,1094,W06000010,W99999999,W99999999,00NU,"Above 1,000 (b)",11,10
3869,SWLNI,14050,9205,4845,4087,9963,W06000015,W99999999,W99999999,00PT,Small City,3,50
3870,SWLNN,617,65,552,12,605,W06000010,W99999999,W99999999,00NU,"Below 1,000 (b)",13,10
3871,SWLPI,906,208,698,58,848,W06000010,W99999999,W99999999,00NU,"Below 1,000 (b)",13,10
3872,SWLQW,549,160,389,81,468,W06000010,W99999999,W99999999,00NU,"Below 1,000 (b)",13,10
3873,SWLY,1353,947,406,726,627,W06000010,W99999999,W99999999,00NU,"Above 1,000 (b)",11,10
3874,SWLYA,390,132,258,99,291,W06000023,W99999999,W99999999,00NN,"Below 1,000 (b)",13,10
3875,SWLYJ,2171,1482,689,1100,1071,W06000010,W99999999,W99999999,00NU,"Above 1,000 (b)",11,10
3876,SWLYW,532,316,216,204,328,W06000023,W99999999,W99999999,00NN,"Below 1,000 (b)",13,10
3877,SWMAD,2972,1591,1381,986,1986,W06000018,W99999999,W99999999,00PK,"Above 1,000 (b)",11,10
3878,SWMAL,8090,6496,1594,3808,4282,W06000013,W99999999,W99999999,00PB,"Above 3,000 (a)",8,30
3879,SWMDE,15526,14811,715,7182,8344,W06000022,W99999999,W99999999,00PR,"Above 10,000 (b)",7,30
3880,SWMDX,448,75,373,10,438,W06000010,W99999999,W99999999,00NU,"Below 1,000 (b)",13,10
3881,SWMES,9274,8227,1047,3388,5886,W06000022,W99999999,W99999999,00PR,"Above 3,000 (b)",9,10
3882,SWMF,7549,6934,615,4195,3354,W06000009,W99999999,W99999999,00NS,"Above 3,000 (b)",9,10
3883,SWMGR,2723,2510,213,1961,762,W06000021,W99999999,W99999999,00PP,"Above 1,000 (b)",11,10
3884,SWMGX,612,241,371,165,447,W06000010,W99999999,W99999999,00NU,"Below 1,000 (b)",13,10
3885,SWMLZ,17373,11407,5966,4275,13098,W06000011,W99999999,W99999999,00NX,Small City,3,50
3886,SWMMN,7903,6002,1901,4077,3826,W06000016,W99999999,W99999999,00PF,"Above 3,000 (b)",9,10
3887,SWMMV,4688,4688,0,2755,1933,W06000011,W99999999,W99999999,00NX,"Above 3,000 (b)",9,10
3888,SWMNF,1041,632,409,92,949,W06000009,W99999999,W99999999,00NS,"Above 1,000 (b)",11,10
3889,SWMT/EX,19049,12048,7001,5266,13783,W06000024,W99999999,W99999999,00PH,"Above 10,000 (b)",7,30
3890,SWMU,5551,5104,447,1993,3558,W06000021,W99999999,W99999999,00PP,"Above 3,000 (b)",9,10
3891,SWMWY,331,39,292,9,322,W06000009,W99999999,W99999999,00NS,"Below 1,000 (b)",13,10
3892,SWMYE,280,126,154,84,196,W06000009,W99999999,W99999999,00NS,"Below 1,000 (b)",13,10
3893,SWMYG,328,56,272,17,311,W06000023,W99999999,W99999999,00NN,"Below 1,000 (b)",13,10
3894,SWMYS,3939,3921,18,2524,1415,W06000011,W99999999,W99999999,00NX,"Above 3,000 (b)",9,10
3895,SWMYU,589,269,320,38,551,W06000010,W99999999,W99999999,00NU,"Below 1,000 (b)",13,10
3896,SWNB,2023,1497,526,1354,669,W06000009,W99999999,W99999999,00NS,"Above 1,000 (a)",10,10
3897,SWNBI,8319,5519,2800,2022,6297,W06000018,W99999999,W99999999,00PK,"Above 3,000 (b)",9,10
3898,SWNDO,1006,815,191,662,344,W06000009,W99999999,W99999999,00NS,"Above 1,000 (b)",11,10
3899,SWNDU,1413,970,443,633,780,W06000008,W99999999,W99999999,00NQ,"Above 1,000 (b)",11,10
3900,SWNE/CH,9494,7450,2044,2815,6679,W06000022,W99999999,W99999999,00PR,"Above 3,000 (b)",9,10
3901,SWNE/EX,12110,12110,0,5244,6866,W06000022,W99999999,W99999999,00PR,"Above 10,000 (a)",6,30
3902,SWNEN,1717,1098,619,826,891,W06000010,W99999999,W99999999,00NU,"Above 1,000 (b)",11,10
3903,SWNES,3074,2095,979,1834,1240,W06000009,W99999999,W99999999,00NS,"Above 3,000 (b)",9,10
3904,SWNM,15299,11818,3481,4581,10718,W06000012,W99999999,W99999999,00NZ,Small City,3,50
3905,SWNNA,712,320,392,149,563,W06000010,W99999999,W99999999,00NU,"Below 1,000 (b)",13,10
3906,SWNSN,2983,2160,823,2017,966,W06000018,W99999999,W99999999,00PK,"Above 1,000 (b)",11,10
3907,SWNTD,1016,757,259,561,455,W06000021,W99999999,W99999999,00PP,"Above 1,000 (b)",11,10
3908,SWNVW,8723,8117,606,2899,5824,W06000015,W99999999,W99999999,00PT,Small City,3,50
3909,SWOAG,3491,2100,1391,1281,2210,W06000016,W99999999,W99999999,00PF,"Above 3,000 (b)",9,10
3910,SWPBL,2317,1412,905,878,1439,W06000010,W99999999,W99999999,00NU,"Above 1,000 (b)",11,10
3911,SWPBM,13839,12575,1264,6924,6915,W06000015,W99999999,W99999999,00PT,Small City,3,50
3912,SWPDU,5540,4581,959,2520,3020,W06000012,W99999999,W99999999,00NZ,"Above 3,000 (b)",9,10
3913,SWPDW,4859,4234,625,2895,1964,W06000010,W99999999,W99999999,00NU,"Above 3,000 (b)",9,10
3914,SWPEC,766,532,234,362,404,W06000010,W99999999,W99999999,00NU,"Below 1,000 (b)",13,10
3915,SWPEK,2355,1677,678,1017,1338,W06000013,W99999999,W99999999,00PB,"Above 1,000 (b)",11,10
3916,SWPEU,7858,6620,1238,3221,4637,W06000013,W99999999,W99999999,00PB,"Above 3,000 (b)",9,10
3917,SWPEV,491,257,234,155,336,W06000010,W99999999,W99999999,00NU,"Below 1,000 (b)",13,10
3918,SWPHX,842,545,297,247,595,W06000021,W99999999,W99999999,00PP,"Below 1,000 (b)",13,10
3919,SWPM,9108,5693,3415,2478,6630,W06000009,W99999999,W99999999,00NS,"Above 3,000 (b)",9,10
3920,SWPMQ,1122,704,418,97,1025,W06000011,W99999999,W99999999,00NX,"Above 1,000 (b)",11,10
3921,SWPN,11122,8389,2733,3554,7568,W06000016,W99999999,W99999999,00PF,"Above 10,000 (a)",6,30
3922,SWPND,7256,4155,3101,3231,4025,W06000014,W99999999,W99999999,00PD,"Above 3,000 (b)",9,10
3923,SWPOM,563,192,371,121,442,W06000008,W99999999,W99999999,00NQ,"Below 1,000 (b)",13,10
3924,SWPP,10218,8736,1482,2022,8196,W06000021,W99999999,W99999999,00PP,"Above 10,000 (b)",7,30
3925,SWPQS,581,100,481,39,542,W06000010,W99999999,W99999999,00NU,"Below 1,000 (b)",13,10
3926,SWPRU,792,528,264,266,526,W06000014,W99999999,W99999999,00PD,"Below 1,000 (b)",13,10
3927,SWPTB,11661,8386,3275,3564,8097,W06000012,W99999999,W99999999,00NZ,Small City,3,50
3928,SWPTH,8472,7017,1455,3639,4833,W06000016,W99999999,W99999999,00PF,"Above 3,000 (b)",9,10
3929,SWPTM,2403,1227,1176,833,1570,W06000010,W99999999,W99999999,00NU,"Above 1,000 (b)",11,10
3930,SWPTY,2216,1985,231,833,1383,W06000015,W99999999,W99999999,00PT,"Above 1,000 (b)",11,10
3931,SWPUN,406,111,295,75,331,W06000009,W99999999,W99999999,00NS,"Below 1,000 (b)",13,10
3932,SWPYH,2052,1484,568,452,1600,W06000010,W99999999,W99999999,00NU,"Above 1,000 (b)",11,10
3933,SWQCT,581,234,347,141,440,W06000009,W99999999,W99999999,00NS,"Below 1,000 (b)",13,10
3934,SWQFJ,425,114,311,90,335,W06000010,W99999999,W99999999,00NU,"Below 1,000 (b)",13,10
3935,SWQHV,896,696,200,553,343,W06000009,W99999999,W99999999,00NS,"Below 1,000 (b)",13,10
3936,SWQJA,10780,6171,4609,3652,7128,W06000018,W99999999,W99999999,00PK,"Above 10,000 (a)",6,30
3937,SWQKL,495,229,266,30,465,W06000010,W99999999,W99999999,00NU,"Below 1,000 (b)",13,10
3938,SWQOB,899,480,419,180,719,W06000023,W99999999,W99999999,00NN,"Below 1,000 (a)",12,10
3939,SWQOE,1336,681,655,632,704,W06000018,W99999999,W99999999,00PK,"Above 1,000 (b)",11,10
3940,SWQTI,2235,1921,314,1201,1034,W06000011,W99999999,W99999999,00NX,"Above 1,000 (b)",11,10
3941,SWRAG,963,697,266,601,362,W06000021,W99999999,W99999999,00PP,"Below 1,000 (b)",13,10
3942,SWRDA,5157,4215,942,1796,3361,W06000018,W99999999,W99999999,00PK,"Above 3,000 (b)",9,10
3943,SWRDX,6265,5692,573,3260,3005,W06000018,W99999999,W99999999,00PK,"Above 3,000 (b)",9,10
3944,SWRHA,249,98,151,66,183,W06000010,W99999999,W99999999,00NU,"Below 1,000 (b)",13,10
3945,SWRHR,2806,2568,238,1872,934,W06000014,W99999999,W99999999,00PD,"Above 1,000 (b)",11,10
3946,SWRLS,1034,224,810,57,977,W06000008,W99999999,W99999999,00NQ,"Above 1,000 (b)",11,10
3947,SWRRY,8269,7516,753,1905,6364,W06000015,W99999999,W99999999,00PT,Small City,3,50
3948,SWRSO,333,43,290,12,321,W06000009,W99999999,W99999999,00NS,"Below 1,000 (b)",13,10
3949,SWRSV,2100,1225,875,966,1134,W06000012,W99999999,W99999999,00NZ,"Above 1,000 (b)",11,10
3950,SWRTH,16205,15222,983,5474,10731,W06000015,W99999999,W99999999,00PT,Small City,3,50
3951,SWRVH,18027,14840,3187,4978,13049,W06000011,W99999999,W99999999,00NX,Small City,3,50
3952,SWRWI,7934,6936,998,2869,5065,W06000022,W99999999,W99999999,00PR,"Above 3,000 (b)",9,10
3953,SWSAS,1717,1242,475,790,927,W06000010,W99999999,W99999999,00NU,"Above 1,000 (a)",10,10
3954,SWSAW,1851,575,1276,410,1441,W06000009,W99999999,W99999999,00NS,"Above 1,000 (b)",11,10
3955,SWSDV,4286,2111,2175,1508,2778,W06000009,W99999999,W99999999,00NS,"Above 3,000 (b)",9,10
3956,SWSFJ,416,120,296,32,384,W06000021,W99999999,W99999999,00PP,"Below 1,000 (b)",13,10
3957,SWSKJ,13122,9953,3169,2799,10323,W06000011,W99999999,W99999999,00NX,Small City,3,50
3958,SWSKU,8768,5976,2792,3410,5358,W06000012,W99999999,W99999999,00NZ,Small City,3,50
3959,SWSMX,1239,695,544,109,1130,W06000014,W99999999,W99999999,00PD,"Above 1,000 (b)",11,10
3960,SWSNI,253,112,141,30,223,W06000009,W99999999,W99999999,00NS,"Below 1,000 (b)",13,10
3961,SWSSQ,1492,1056,436,802,690,W06000012,W99999999,W99999999,00NZ,"Above 1,000 (b)",11,10
3962,SWSVB,1056,386,670,274,782,W06000023,W99999999,W99999999,00NN,"Above 1,000 (a)",10,10
3963,SWSX,21962,18847,3115,7651,14311,W06000012,W99999999,W99999999,00NZ,Small City,3,50
3964,SWSZX,23739,11676,12063,4484,19255,W06000015,W99999999,W99999999,00PT,Small City,3,50
3965,SWTAF,1168,919,249,643,525,W06000023,W99999999,W99999999,00NN,"Above 1,000 (a)",10,10
3966,SWTAJ,6581,5929,652,2088,4493,W06000021,W99999999,W99999999,00PP,"Above 3,000 (b)",9,10
3967,SWTAT,2847,2734,113,1494,1353,W06000015,W99999999,W99999999,00PT,"Above 1,000 (b)",11,10
3968,SWTB,3733,3416,317,2822,911,W06000009,W99999999,W99999999,00NS,"Above 3,000 (b)",9,10
3969,SWTDE,1032,544,488,144,888,W06000021,W99999999,W99999999,00PP,"Above 1,000 (b)",11,10
3970,SWTDU,12505,8647,3858,3249,9256,W06000016,W99999999,W99999999,00PF,"Above 10,000 (b)",7,30
3971,SWTEK,908,295,613,68,840,W06000021,W99999999,W99999999,00PP,"Below 1,000 (b)",13,10
3972,SWTEZ,4001,3889,112,2859,1142,W06000018,W99999999,W99999999,00PK,"Above 3,000 (b)",9,10
3973,SWTFA,10073,5910,4163,2635,7438,W06000016,W99999999,W99999999,00PF,"Above 10,000 (b)",7,30
3974,SWTFS,4559,2658,1901,364,4195,W06000015,W99999999,W99999999,00PT,"Above 3,000 (b)",9,10
3975,SWTLL,591,134,457,21,570,W06000010,W99999999,W99999999,00NU,"Below 1,000 (b)",13,10
3976,SWTLU,316,199,117,165,151,W06000023,W99999999,W99999999,00NN,"Below 1,000 (b)",13,10
3977,SWTR,7396,6586,810,3219,4177,W06000018,W99999999,W99999999,00PK,"Above 3,000 (b)",9,10
3978,SWTRF,6874,4610,2264,2558,4316,W06000016,W99999999,W99999999,00PF,"Above 3,000 (b)",9,10
3979,SWTRH,680,262,418,81,599,W06000009,W99999999,W99999999,00NS,"Below 1,000 (b)",13,10
3980,SWTSA,1537,1341,196,808,729,W06000010,W99999999,W99999999,00NU,"Above 1,000 (b)",11,10
3981,SWTUC,501,271,230,33,468,W06000021,W99999999,W99999999,00PP,"Below 1,000 (b)",13,10
3982,SWUAH,1900,1471,429,1356,544,W06000021,W99999999,W99999999,00PP,"Above 1,000 (a)",10,10
3983,SWUAZ,739,140,599,20,719,W06000010,W99999999,W99999999,00NU,"Below 1,000 (b)",13,10
3984,SWUCW,1356,1148,208,436,920,W06000012,W99999999,W99999999,00NZ,"Above 1,000 (a)",10,10
3985,SWUGI,473,234,239,156,317,W06000011,W99999999,W99999999,00NX,"Below 1,000 (a)",12,10
3986,SWUGU,571,187,384,158,413,W06000023,W99999999,W99999999,00NN,"Below 1,000 (b)",13,10
3987,SWUHN,301,165,136,22,279,W06000009,W99999999,W99999999,00NS,"Below 1,000 (b)",13,10
3988,SWUTK,569,448,121,126,443,W06000021,W99999999,W99999999,00PP,"Below 1,000 (b)",13,10
3989,SWUWN,4767,4081,686,803,3964,W06000022,W99999999,W99999999,00PR,"Above 3,000 (b)",9,10
3990,SWVLD,1643,791,852,477,1166,W06000010,W99999999,W99999999,00NU,"Above 1,000 (b)",11,10
3991,SWVVW,663,236,427,14,649,W06000021,W99999999,W99999999,00PP,"Below 1,000 (b)",13,10
3992,SWWCP,1010,571,439,293,717,W06000021,W99999999,W99999999,00PP,"Above 1,000 (b)",11,10
3993,SWWHT,1217,954,263,679,538,W06000010,W99999999,W99999999,00NU,"Above 1,000 (b)",11,10
3994,SWWXC,17745,16266,1479,7236,10509,W06000015,W99999999,W99999999,00PT,Small City,3,50
3995,SWXNH,6009,3772,2237,1811,4198,W06000018,W99999999,W99999999,00PK,"Above 3,000 (b)",9,10
3996,SWXSX,642,347,295,262,380,W06000021,W99999999,W99999999,00PP,"Below 1,000 (b)",13,10
3997,SWXTP,1879,1600,279,1028,851,W06000014,W99999999,W99999999,00PD,"Above 1,000 (b)",11,10
3998,SWXUU,3194,2916,278,1284,1910,W06000014,W99999999,W99999999,00PD,"Above 3,000 (b)",9,10
3999,SWYBL,2375,1676,699,1280,1095,W06000016,W99999999,W99999999,00PF,"Above 1,000 (b)",11,10
4000,SWYDU,1712,1332,380,756,956,W06000018,W99999999,W99999999,00PK,"Above 1,000 (b)",11,10
4001,SWYRO,553,155,398,56,497,W06000010,W99999999,W99999999,00NU,"Below 1,000 (b)",13,10
4002,SWYYN,2969,2560,409,1563,1406,W06000016,W99999999,W99999999,00PF,"Above 1,000 (b)",11,10
4003,SWZEN,933,503,430,242,691,W06000010,W99999999,W99999999,00NU,"Below 1,000 (b)",13,10
4004,SWZFR,1118,441,677,126,992,W06000009,W99999999,W99999999,00NS,"Above 1,000 (b)",11,10
4005,SWZIU,878,496,382,314,564,W06000009,W99999999,W99999999,00NS,"Below 1,000 (b)",13,10
4006,SWZIY,777,466,311,369,408,W06000009,W99999999,W99999999,00NS,"Below 1,000 (b)",13,10
4007,SWZKA,308,95,213,45,263,W06000021,W99999999,W99999999,00PP,"Below 1,000 (b)",13,10
4008,SWZKS,3225,2999,226,1400,1825,W06000018,W99999999,W99999999,00PK,"Above 3,000 (b)",9,10
4009,SWZLD,582,154,428,105,477,W06000010,W99999999,W99999999,00NU,"Below 1,000 (b)",13,10
4010,SWZMX,295,109,186,13,282,W06000009,W99999999,W99999999,00NS,"Below 1,000 (b)",13,10
4011,SWZNR,510,225,285,173,337,W06000009,W99999999,W99999999,00NS,"Below 1,000 (b)",13,10
4012,SWZNT,9070,5123,3947,2366,6704,W06000012,W99999999,W99999999,00NZ,Small City,3,50
4013,SWZWJ,412,106,306,35,377,W06000009,W99999999,W99999999,00NS,"Below 1,000 (b)",13,10
4014,SWZWM,2417,1983,434,1326,1091,W06000018,W99999999,W99999999,00PK,"Above 1,000 (b)",11,10
4015,SWZYY,142,45,97,19,123,W06000010,W99999999,W99999999,00NU,"Below 1,000 (b)",13,10
4016,SWZZH,1012,274,738,72,940,W06000009,W99999999,W99999999,00NS,"Above 1,000 (b)",11,10
4017,THAD,24227,17014,7213,7293,16934,E07000209,E10000030,E12000008,43,"Above 20,000 (b)",5,30
4018,THAFD,3138,1775,1363,529,2609,E06000041,E99999999,E12000008,00MF,"Above 3,000 (b)",9,10
4019,THAG,1313,906,407,284,1029,E07000209,E10000030,E12000008,43,"Above 1,000 (b)",11,10
4020,THAS,7348,5348,2000,2400,4948,E07000214,E10000030,E12000008,43,Small City,3,50
4021,THATN,9302,8273,1029,4714,4588,E07000085,E10000014,E12000008,24,"Above 3,000 (a)",8,30
4022,THBA,9289,5393,3896,2407,6882,E07000214,E10000030,E12000008,43,Small City,3,50
4023,THBC,679,570,109,270,409,E07000225,E10000032,E12000008,45,"Below 1,000 (b)",13,10
4024,THBD,385,222,163,148,237,E06000037,E99999999,E12000008,00MB,"Below 1,000 (b)",13,10
4025,THBEN,10063,4568,5495,2843,7220,E06000040,E99999999,E12000008,00ME,"Above 10,000 (b)",7,30
4026,THBFD,864,253,611,120,744,E06000037,E99999999,E12000008,00MB,"Below 1,000 (b)",13,10
4027,THBG,3077,2803,274,2327,750,E06000037,E99999999,E12000008,00MB,"Above 3,000 (b)",9,10
4028,THBK,31524,17070,14454,4431,27093,E06000036,E99999999,E12000008,00MA,"Above 20,000 (b)",5,30
4029,THBL,4829,2750,2079,1507,3322,E07000209,E10000030,E12000008,43,"Above 3,000 (b)",9,10
4030,THBN,9341,8730,611,3211,6130,E06000040,E99999999,E12000008,00ME,"Above 3,000 (b)",9,10
4031,THBO,11757,7934,3823,2244,9513,E07000209,E10000030,E12000008,43,"Above 10,000 (a)",6,30
4032,THBR,7429,6909,520,3616,3813,E07000085,E10000014,E12000008,24,"Above 3,000 (b)",9,10
4033,THBRK,679,360,319,98,581,E07000084,E10000014,E12000008,24,"Below 1,000 (b)",13,10
4034,THBT,1471,664,807,466,1005,E07000216,E10000030,E12000008,43,"Above 1,000 (b)",11,10
4035,THBW,14333,7680,6653,2258,12075,E07000092,E10000014,E12000008,24,Small City,3,50
4036,THBZ,29781,14235,15546,5890,23891,E07000084,E10000014,E12000008,24,"Above 20,000 (a)",4,30
4037,THC,15173,10894,4279,4829,10344,E07000092,E10000014,E12000008,24,Small City,3,50
4038,THCDN,5978,1374,4604,254,5724,E07000209,E10000030,E12000008,43,"Above 3,000 (b)",9,10
4039,THCH,4020,1897,2123,1018,3002,E07000217,E10000030,E12000008,43,"Above 3,000 (b)",9,10
4040,THCHD,689,270,419,150,539,E06000037,E99999999,E12000008,00MB,"Below 1,000 (b)",13,10
4041,THCHN,13631,11626,2005,3255,10376,E07000084,E10000014,E12000008,24,"Above 10,000 (a)",6,30
4042,THCK,3294,2623,671,1562,1732,E06000040,E99999999,E12000008,00ME,"Above 3,000 (b)",9,10
4043,THCKN,1783,1224,559,984,799,E07000179,E10000025,E12000008,38,"Above 1,000 (b)",11,10
4044,THCL,3076,904,2172,504,2572,E07000216,E10000030,E12000008,43,"Above 3,000 (b)",9,10
4045,THCLY,2109,1639,470,1241,868,E07000179,E10000025,E12000008,38,"Above 1,000 (b)",11,10
4046,THCMN,916,652,264,571,345,E07000179,E10000025,E12000008,38,"Below 1,000 (b)",13,10
4047,THCN,5477,4705,772,2769,2708,E07000209,E10000030,E12000008,43,"Above 3,000 (b)",9,10
4048,THCP,1414,981,433,555,859,E07000227,E10000032,E12000008,45,"Above 1,000 (b)",11,10
4049,THCV,15965,12490,3475,5275,10690,E07000179,E10000025,E12000008,38,"Above 10,000 (b)",7,30
4050,THCW,9718,6859,2859,3385,6333,E06000036,E99999999,E12000008,00MA,"Above 3,000 (b)",9,10
4051,THCY,993,466,527,307,686,E06000037,E99999999,E12000008,00MB,"Below 1,000 (b)",13,10
4052,THDC,7020,4448,2572,397,6623,E07000209,E10000030,E12000008,43,"Above 3,000 (b)",9,10
4053,THDF,815,453,362,239,576,E07000216,E10000030,E12000008,43,"Below 1,000 (b)",13,10
4054,THDG,822,488,334,169,653,E07000211,E10000030,E12000008,43,"Below 1,000 (b)",13,10
4055,THDK,10034,7193,2841,4012,6022,E07000210,E10000030,E12000008,43,"Above 10,000 (b)",7,30
4056,THDM,2784,508,2276,107,2677,E07000094,E10000014,E12000008,24,"Above 1,000 (b)",11,10
4057,THEAR,11142,9755,1387,6536,4606,E06000041,E99999999,E12000008,00MF,Small City,3,50
4058,THED,1519,1172,347,1007,512,E07000209,E10000030,E12000008,43,"Above 1,000 (b)",11,10
4059,THEI,561,277,284,240,321,E07000180,E10000025,E12000008,38,"Below 1,000 (b)",13,10
4060,THEV,2620,644,1976,257,2363,E07000089,E10000014,E12000008,24,"Above 1,000 (b)",11,10
4061,THEY,3454,2201,1253,649,2805,E07000209,E10000030,E12000008,43,"Above 3,000 (b)",9,10
4062,THFB,20432,11438,8994,4769,15663,E07000209,E10000030,E12000008,43,"Above 20,000 (b)",5,30
4063,THFC,3200,2794,406,1417,1783,E07000006,E10000002,E12000008,11,"Above 3,000 (b)",9,10
4064,THFJ,13578,9022,4556,4003,9575,E07000216,E10000030,E12000008,43,"Above 10,000 (b)",7,30
4065,THFM,2738,2034,704,214,2524,E07000006,E10000002,E12000008,11,"Above 1,000 (b)",11,10
4066,THFN,2604,728,1876,280,2324,E07000216,E10000030,E12000008,43,"Above 1,000 (b)",11,10
4067,THFT,16184,12071,4113,4261,11923,E07000092,E10000014,E12000008,24,Small City,3,50
4068,THFTG,1069,228,841,122,947,E07000209,E10000030,E12000008,43,"Above 1,000 (b)",11,10
4069,THGG,12007,8801,3206,3483,8524,E07000209,E10000030,E12000008,43,"Above 10,000 (b)",7,30
4070,THGI,24386,15038,9348,7412,16974,E07000209,E10000030,E12000008,43,"Above 20,000 (b)",5,30
4071,THGO,2391,1960,431,1450,941,E07000179,E10000025,E12000008,38,"Above 1,000 (b)",11,10
4072,THGRS,754,424,330,273,481,E06000037,E99999999,E12000008,00MB,"Below 1,000 (b)",13,10
4073,THGX,6700,4523,2177,1860,4840,E07000006,E10000002,E12000008,11,"Above 3,000 (b)",9,10
4074,THH,3992,3435,557,2288,1704,E07000089,E10000014,E12000008,24,"Above 3,000 (b)",9,10
4075,THHC,2339,1392,947,939,1400,E07000084,E10000014,E12000008,24,"Above 1,000 (b)",11,10
4076,THHD,510,152,358,70,440,E07000085,E10000014,E12000008,24,"Below 1,000 (b)",13,10
4077,THHDY,1216,779,437,226,990,E07000084,E10000014,E12000008,24,"Above 1,000 (a)",10,10
4078,THHE,3325,2889,436,2396,929,E06000054,E99999999,E12000009,00HY,"Above 3,000 (b)",9,10
4079,THHF,736,331,405,58,678,E07000089,E10000014,E12000008,24,"Below 1,000 (a)",12,10
4080,THHH,3620,2982,638,1263,2357,E07000216,E10000030,E12000008,43,"Above 3,000 (b)",9,10
4081,THHM,7646,5068,2578,2609,5037,E07000225,E10000032,E12000008,45,"Above 3,000 (b)",9,10
4082,THHN,2855,2216,639,1059,1796,E07000216,E10000030,E12000008,43,"Above 1,000 (b)",11,10
4083,THHRJ,1789,1079,710,622,1167,E06000037,E99999999,E12000008,00MB,"Above 1,000 (b)",11,10
4084,THHS,535,241,294,122,413,E07000216,E10000030,E12000008,43,"Below 1,000 (b)",13,10
4085,THHT,7153,6454,699,4874,2279,E06000041,E99999999,E12000008,00MF,Small City,3,50
4086,THHW,2996,2640,356,1949,1047,E07000089,E10000014,E12000008,24,"Above 1,000 (b)",11,10
4087,THIN,1280,401,879,221,1059,E06000054,E99999999,E12000009,00HY,"Above 1,000 (b)",11,10
4088,THIP,5246,3808,1438,1374,3872,E09000017,E99999999,E12000007,00London,"Above 3,000 (b)",9,10
4089,THKB,795,125,670,35,760,E06000037,E99999999,E12000008,00MB,"Below 1,000 (b)",13,10
4090,THKC,2054,1571,483,1404,650,E07000084,E10000014,E12000008,24,"Above 1,000 (b)",11,10
4091,THKE,2910,2348,562,1721,1189,E07000179,E10000025,E12000008,38,"Above 1,000 (b)",11,10
4092,THLG,5530,1256,4274,289,5241,E06000036,E99999999,E12000008,00MA,"Above 3,000 (b)",9,10
4093,THLL,12585,11633,952,5684,6901,E06000040,E99999999,E12000008,00ME,"Above 10,000 (a)",6,30
4094,THLM,2022,1550,472,1437,585,E07000180,E10000025,E12000008,38,"Above 1,000 (b)",11,10
4095,THLP,3744,3487,257,2452,1292,E07000225,E10000032,E12000008,45,"Above 3,000 (b)",9,10
4096,THLSN,806,342,464,194,612,E07000085,E10000014,E12000008,24,"Below 1,000 (b)",13,10
4097,THM,24965,17612,7353,6664,18301,E06000040,E99999999,E12000008,00ME,"Above 20,000 (b)",5,30
4098,THMD,531,276,255,159,372,E07000225,E10000032,E12000008,45,"Below 1,000 (b)",13,10
4099,THML,9858,7921,1937,4854,5004,E06000040,E99999999,E12000008,00ME,"Above 3,000 (b)",9,10
4100,THMO,1849,1704,145,1299,550,E07000084,E10000014,E12000008,24,"Above 1,000 (b)",11,10
4101,THMS,2288,617,1671,131,2157,E07000084,E10000014,E12000008,24,"Above 1,000 (b)",11,10
4102,THMSD,3168,2633,535,1067,2101,E07000085,E10000014,E12000008,24,"Above 3,000 (b)",9,10
4103,THNB,889,425,464,309,580,E07000179,E10000025,E12000008,38,"Below 1,000 (b)",13,10
4104,THNE,1408,609,799,277,1131,E07000210,E10000030,E12000008,43,"Above 1,000 (b)",11,10
4105,THNL,798,381,417,292,506,E07000225,E10000032,E12000008,45,"Below 1,000 (b)",13,10
4106,THNU,19430,16465,2965,7180,12250,E07000084,E10000014,E12000008,24,"Above 10,000 (b)",7,30
4107,THOH,2344,2055,289,948,1396,E07000089,E10000014,E12000008,24,"Above 1,000 (b)",11,10
4108,THOK,4710,2209,2501,1043,3667,E07000084,E10000014,E12000008,24,"Above 3,000 (b)",9,10
4109,THOL,746,300,446,70,676,E07000227,E10000032,E12000008,45,"Below 1,000 (b)",13,10
4110,THOV,2116,1905,211,1778,338,E07000084,E10000014,E12000008,24,"Above 1,000 (b)",11,10
4111,THP,2814,2164,650,1426,1388,E07000179,E10000025,E12000008,38,"Above 1,000 (b)",11,10
4112,THPC,563,207,356,137,426,E07000085,E10000014,E12000008,24,"Below 1,000 (b)",13,10
4113,THPM,1976,594,1382,128,1848,E07000209,E10000030,E12000008,43,"Above 1,000 (b)",11,10
4114,THPS,547,484,63,318,229,E07000085,E10000014,E12000008,24,"Below 1,000 (b)",13,10
4115,THRD,1768,1059,709,341,1427,E07000209,E10000030,E12000008,43,"Above 1,000 (b)",11,10
4116,THRG,19540,17293,2247,8784,10756,E06000038,E99999999,E12000008,00MC,Small City,3,50
4117,THRO,955,466,489,123,832,E07000179,E10000025,E12000008,38,"Below 1,000 (b)",13,10
4118,THS,18175,13708,4467,5025,13150,E06000041,E99999999,E12000008,00MF,Small City,3,50
4119,THSBN,462,340,122,258,204,E07000085,E10000014,E12000008,24,"Below 1,000 (b)",13,10
4120,THSCR,1752,1552,200,553,1199,E07000084,E10000014,E12000008,24,"Above 1,000 (b)",11,10
4121,THSE,1482,1019,463,538,944,E07000209,E10000030,E12000008,43,"Above 1,000 (b)",11,10
4122,THSL,18231,17022,1209,7908,10323,E06000040,E99999999,E12000008,00ME,"Above 10,000 (a)",6,30
4123,THSL/UD,19760,18941,819,4289,15471,E06000040,E99999999,E12000008,00ME,"Above 10,000 (b)",7,30
4124,THSPD,4813,2820,1993,1565,3248,E06000041,E99999999,E12000008,00MF,"Above 3,000 (b)",9,10
4125,THT,12089,11027,1062,6072,6017,E06000037,E99999999,E12000008,00MB,"Above 10,000 (b)",7,30
4126,THTAD,6598,6105,493,3168,3430,E07000084,E10000014,E12000008,24,"Above 3,000 (b)",9,10
4127,THTF,5425,4606,819,2571,2854,E06000041,E99999999,E12000008,00MF,"Above 3,000 (a)",8,30
4128,THTG,3049,1527,1522,647,2402,E07000089,E10000014,E12000008,24,"Above 3,000 (b)",9,10
4129,THTH,3601,2818,783,1610,1991,E06000037,E99999999,E12000008,00MB,"Above 3,000 (b)",9,10
4130,THTI,535,366,169,272,263,E07000085,E10000014,E12000008,24,"Below 1,000 (b)",13,10
4131,THTT,24290,18137,6153,6062,18228,E07000179,E10000025,E12000008,38,"Above 20,000 (b)",5,30
4132,THTV,586,198,388,51,535,E07000007,E10000002,E12000008,11,"Below 1,000 (b)",13,10
4133,THUB,908,658,250,362,546,E06000037,E99999999,E12000008,00MB,"Below 1,000 (b)",13,10
4134,THWA,2642,2054,588,1186,1456,E06000041,E99999999,E12000008,00MF,"Above 1,000 (a)",10,10
4135,THWDY,15985,11226,4759,5348,10637,E06000041,E99999999,E12000008,00MF,Small City,3,50
4136,THWI,2424,2248,176,2046,378,E07000084,E10000014,E12000008,24,"Above 1,000 (a)",10,10
4137,THWK,23951,18877,5074,6541,17410,E07000209,E10000030,E12000008,43,"Above 20,000 (b)",5,30
4138,THWL,5863,4496,1367,3657,2206,E07000179,E10000025,E12000008,38,"Above 3,000 (a)",8,30
4139,THWM,18490,13422,5068,5072,13418,E06000036,E99999999,E12000008,00MA,"Above 10,000 (b)",7,30
4140,THWN,2067,610,1457,281,1786,E06000037,E99999999,E12000008,00MB,"Above 1,000 (b)",11,10
4141,THWO,17514,10509,7005,5647,11867,E06000040,E99999999,E12000008,00ME,"Above 10,000 (a)",6,30
4142,THWP,7127,2229,4898,324,6803,E07000209,E10000030,E12000008,43,"Above 3,000 (b)",9,10
4143,THWR,7405,4306,3099,890,6515,E06000036,E99999999,E12000008,00MA,"Above 3,000 (b)",9,10
4144,THWT,1955,1251,704,1144,811,E07000007,E10000002,E12000008,11,"Above 1,000 (b)",11,10
4145,THWTH,3542,2653,889,441,3101,E07000214,E10000030,E12000008,43,"Above 3,000 (b)",9,10
4146,THWY,3350,1023,2327,470,2880,E07000216,E10000030,E12000008,43,"Above 3,000 (b)",9,10
4147,THY,8954,8131,823,2479,6475,E07000089,E10000014,E12000008,24,"Above 3,000 (b)",9,10
4148,WEWBAY,15943,15943,0,12401,3542,E09000033,E99999999,E12000007,00London,Inner London,1,50
4149,WEWBLO,5324,5324,0,5324,0,E09000007,E99999999,E12000007,00London,Inner London,1,50
4150,WEWHAM,17838,17837,1,11005,6833,E09000007,E99999999,E12000007,00London,Inner London,1,50
4151,WEWLOR,8800,8800,0,7725,1075,E09000033,E99999999,E12000007,00London,Inner London,1,50
4152,WEWMAI,14073,14073,0,11645,2428,E09000007,E99999999,E12000007,00London,Inner London,1,50
4153,WEWMAR,4456,4456,0,4452,4,E09000007,E99999999,E12000007,00London,Inner London,1,50
4154,WEWMAY,3654,3654,0,3640,14,E09000033,E99999999,E12000007,00London,Inner London,1,50
4155,WEWNPN,5674,5674,0,5674,0,E09000033,E99999999,E12000007,00London,Inner London,1,50
4156,WEWPAD,4866,4866,0,4865,1,E09000033,E99999999,E12000007,00London,Inner London,1,50
4157,WEWPRI,8690,8690,0,7051,1639,E09000007,E99999999,E12000007,00London,Inner London,1,50
4158,WEWSOH,4445,4445,0,4445,0,E09000007,E99999999,E12000007,00London,Inner London,1,50
4159,WMADB,390,200,190,89,301,E07000197,E10000028,E12000005,41,"Below 1,000 (b)",13,10
4160,WMADM,1522,989,533,765,757,E06000049,E99999999,E12000002,00EQ,"Above 1,000 (a)",10,10
4161,WMADY,3774,3112,662,1768,2006,E06000049,E99999999,E12000002,00EQ,"Above 3,000 (b)",9,10
4162,WMALS,7760,6502,1258,3502,4258,E06000049,E99999999,E12000002,00EQ,"Above 3,000 (b)",9,10
4163,WMARL,524,231,293,47,477,E07000239,E10000034,E12000005,47,"Below 1,000 (b)",13,10
4164,WMASH,8976,5148,3828,1612,7364,E07000198,E10000028,E12000005,41,"Above 3,000 (b)",9,10
4165,WMASN,1083,642,441,238,845,E06000049,E99999999,E12000002,00EQ,"Above 1,000 (b)",11,10
4166,WMAST,5050,4449,601,1367,3683,E07000221,E10000031,E12000005,44,"Above 3,000 (b)",9,10
4167,WMAUH,1207,432,775,228,979,E07000238,E10000034,E12000005,47,"Above 1,000 (b)",11,10
4168,WMBAD,4280,1931,2349,1055,3225,E07000238,E10000034,E12000005,47,"Above 3,000 (b)",9,10
4169,WMBAR,2084,1680,404,766,1318,E06000021,E99999999,E12000005,00GL,"Above 1,000 (b)",11,10
4170,WMBBN,1540,872,668,476,1064,E07000234,E10000034,E12000005,47,"Above 1,000 (b)",11,10
4171,WMBDY,2773,1992,781,1288,1485,E07000238,E10000034,E12000005,47,"Above 1,000 (a)",10,10
4172,WMBET,1410,549,861,379,1031,E06000049,E99999999,E12000002,00EQ,"Above 1,000 (b)",11,10
4173,WMBEW,5176,4517,659,3255,1921,E07000239,E10000034,E12000005,47,"Above 3,000 (b)",9,10
4174,WMBGM,242,120,122,55,187,E06000049,E99999999,E12000002,00EQ,"Below 1,000 (b)",13,10
4175,WMBID,10514,8053,2461,3938,6576,E06000049,E99999999,E12000002,00EQ,"Above 10,000 (b)",7,30
4176,WMBIS,605,360,245,223,382,E07000238,E10000034,E12000005,47,"Below 1,000 (a)",12,10
4177,WMBLA,1124,975,149,646,478,E07000234,E10000034,E12000005,47,"Above 1,000 (b)",11,10
4178,WMBLO,1006,863,143,647,359,E07000079,E10000013,E12000009,23,"Above 1,000 (b)",11,10
4179,WMBLS,423,215,208,69,354,E07000198,E10000028,E12000005,41,"Below 1,000 (b)",13,10
4180,WMBLY,10988,5676,5312,1967,9021,E07000198,E10000028,E12000005,41,"Above 10,000 (b)",7,30
4181,WMBPZ,19941,15002,4939,4845,15096,E07000234,E10000034,E12000005,47,"Above 10,000 (a)",6,30
4182,WMBRA,1027,253,774,126,901,E07000196,E10000028,E12000005,41,"Above 1,000 (b)",11,10
4183,WMBUR,22229,16653,5576,5556,16673,E06000021,E99999999,E12000005,00GL,Small City,3,50
4184,WMCAM,1661,1295,366,947,714,E07000238,E10000034,E12000005,47,"Above 1,000 (b)",11,10
4185,WMCBM,1746,1426,320,1310,436,E06000051,E99999999,E12000005,00GG,"Above 1,000 (b)",11,10
4186,WMCHA,807,467,340,296,511,E07000234,E10000034,E12000005,47,"Below 1,000 (b)",13,10
4187,WMCHD,5944,5523,421,4039,1905,E07000198,E10000028,E12000005,41,"Above 3,000 (a)",8,30
4188,WMCHM,1633,166,1467,78,1555,E06000050,E99999999,E12000002,00EW,"Above 1,000 (b)",11,10
4189,WMCHS,2338,1913,425,1223,1115,E07000198,E10000028,E12000005,41,"Above 1,000 (b)",11,10
4190,WMCIT,15332,14204,1128,5843,9489,E06000021,E99999999,E12000005,00GL,Small City,3,50
4191,WMCLO,566,287,279,126,440,E07000239,E10000034,E12000005,47,"Below 1,000 (b)",13,10
4192,WMCOL,2390,1965,425,609,1781,E07000235,E10000034,E12000005,47,"Above 1,000 (b)",11,10
4193,WMCOT,562,217,345,33,529,E07000235,E10000034,E12000005,47,"Below 1,000 (b)",13,10
4194,WMCRO,1236,986,250,350,886,E07000238,E10000034,E12000005,47,"Above 1,000 (b)",11,10
4195,WMCUT,528,325,203,200,328,E07000238,E10000034,E12000005,47,"Below 1,000 (b)",13,10
4196,WMDAP,532,158,374,24,508,E07000194,E10000028,E12000005,41,"Below 1,000 (b)",13,10
4197,WMDIM,12137,12021,116,6042,6095,E07000195,E10000028,E12000005,41,"Above 10,000 (a)",6,30
4198,WMDRO,11555,10293,1262,3454,8101,E07000238,E10000034,E12000005,47,"Above 10,000 (a)",6,30
4199,WMECC,1810,1567,243,1346,464,E07000197,E10000028,E12000005,41,"Above 1,000 (a)",10,10
4200,WMECK,1157,465,692,216,941,E07000238,E10000034,E12000005,47,"Above 1,000 (a)",10,10
4201,WMELM,589,322,267,189,400,E07000238,E10000034,E12000005,47,"Below 1,000 (b)",13,10
4202,WMEND,3043,2622,421,928,2115,E07000198,E10000028,E12000005,41,"Above 3,000 (b)",9,10
4203,WMEV,12497,12049,448,5012,7485,E07000238,E10000034,E12000005,47,"Above 10,000 (b)",7,30
4204,WMFAD,541,177,364,107,434,E06000049,E99999999,E12000002,00EQ,"Below 1,000 (b)",13,10
4205,WMFER,8381,3798,4583,1239,7142,E07000238,E10000034,E12000005,47,"Above 3,000 (b)",9,10
4206,WMFIE,628,417,211,172,456,E07000198,E10000028,E12000005,41,"Below 1,000 (b)",13,10
4207,WMGNO,2199,1965,234,1772,427,E07000197,E10000028,E12000005,41,"Above 1,000 (b)",11,10
4208,WMGRE,1028,490,538,238,790,E07000239,E10000034,E12000005,47,"Above 1,000 (b)",11,10
4209,WMHAG,4841,4768,73,1267,3574,E07000234,E10000034,E12000005,47,"Above 3,000 (b)",9,10
4210,WMHAL,4081,3039,1042,472,3609,E07000238,E10000034,E12000005,47,"Above 3,000 (b)",9,10
4211,WMHAM,295,214,81,60,235,E07000194,E10000028,E12000005,41,"Below 1,000 (b)",13,10
4212,WMHAN,680,300,380,88,592,E07000234,E10000034,E12000005,47,"Below 1,000 (b)",13,10
4213,WMHAR,1417,1093,324,642,775,E07000238,E10000034,E12000005,47,"Above 1,000 (b)",11,10
4214,WMHAS,26060,18899,7161,6184,19876,E06000049,E99999999,E12000002,00EQ,"Above 20,000 (a)",4,30
4215,WMHAV,1581,912,669,550,1031,E07000221,E10000031,E12000005,44,"Above 1,000 (b)",11,10
4216,WMHCH,4688,3110,1578,2498,2190,E06000050,E99999999,E12000002,00EW,"Above 3,000 (b)",9,10
4217,WMHIL,670,197,473,130,540,E07000198,E10000028,E12000005,41,"Below 1,000 (b)",13,10
4218,WMHIM,542,244,298,107,435,E07000238,E10000034,E12000005,47,"Below 1,000 (b)",13,10
4219,WMHOL,325,176,149,116,209,E07000198,E10000028,E12000005,41,"Below 1,000 (b)",13,10
4220,WMHSW,1353,544,809,129,1224,E07000235,E10000034,E12000005,47,"Above 1,000 (b)",11,10
4221,WMHX,12405,11248,1157,4552,7853,E07000234,E10000034,E12000005,47,"Above 10,000 (b)",7,30
4222,WMINK,1506,829,677,740,766,E07000236,E10000034,E12000005,47,"Above 1,000 (b)",11,10
4223,WMIPN,1545,568,977,428,1117,E07000198,E10000028,E12000005,41,"Above 1,000 (b)",11,10
4224,WMIPS,11836,10854,982,3898,7938,E07000234,E10000034,E12000005,47,"Above 10,000 (b)",7,30
4225,WMKD,24863,18004,6859,7123,17740,E07000238,E10000034,E12000005,47,"Above 20,000 (b)",5,30
4226,WMKDG,15324,10084,5240,3734,11590,E06000049,E99999999,E12000002,00EQ,"Above 10,000 (a)",6,30
4227,WMKEM,2061,1597,464,1154,907,E07000238,E10000034,E12000005,47,"Above 1,000 (b)",11,10
4228,WMKLT,289,133,156,41,248,E06000051,E99999999,E12000005,00GG,"Below 1,000 (b)",13,10
4229,WMKNI,732,374,358,96,636,E07000235,E10000034,E12000005,47,"Below 1,000 (b)",13,10
4230,WMLEE,10050,9714,336,6244,3806,E07000198,E10000028,E12000005,41,"Above 10,000 (a)",6,30
4231,WMLEI,2876,807,2069,323,2553,E07000235,E10000034,E12000005,47,"Above 1,000 (b)",11,10
4232,WMLIT,2130,1960,170,1109,1021,E07000194,E10000028,E12000005,41,"Above 1,000 (b)",11,10
4233,WMLON,25903,19739,6164,5956,19947,E06000021,E99999999,E12000005,00GL,Small City,3,50
4234,WMLOW,539,252,287,91,448,E06000049,E99999999,E12000002,00EQ,"Below 1,000 (b)",13,10
4235,WMMAD,2319,1903,416,1515,804,E07000195,E10000028,E12000005,41,"Above 1,000 (b)",11,10
4236,WMMAL,13629,10856,2773,3249,10380,E07000235,E10000034,E12000005,47,"Above 10,000 (b)",7,30
4237,WMMFD,6555,5603,952,1392,5163,E07000196,E10000028,E12000005,41,"Above 3,000 (b)",9,10
4238,WMMIC,1394,864,530,751,643,E07000221,E10000031,E12000005,44,"Above 1,000 (b)",11,10
4239,WMMTL,13118,9553,3565,3688,9430,E07000198,E10000028,E12000005,41,"Above 10,000 (a)",6,30
4240,WMNAN,9682,9260,422,6512,3170,E06000049,E99999999,E12000002,00EQ,"Above 3,000 (a)",8,30
4241,WMNEW,22114,16690,5424,5775,16339,E07000195,E10000028,E12000005,41,"Above 20,000 (a)",4,30
4242,WMOAK,968,418,550,37,931,E07000198,E10000028,E12000005,41,"Below 1,000 (b)",13,10
4243,WMOMB,1324,661,663,476,848,E07000238,E10000034,E12000005,47,"Above 1,000 (b)",11,10
4244,WMONE,405,92,313,37,368,E07000198,E10000028,E12000005,41,"Below 1,000 (b)",13,10
4245,WMPAX,750,235,515,102,648,E07000221,E10000031,E12000005,44,"Below 1,000 (b)",13,10
4246,WMPEO,1536,1115,421,164,1372,E07000238,E10000034,E12000005,47,"Above 1,000 (b)",11,10
4247,WMPER,4522,4149,373,3144,1378,E07000238,E10000034,E12000005,47,"Above 3,000 (a)",8,30
4248,WMPKR,4013,3577,436,2801,1212,E07000196,E10000028,E12000005,41,"Above 3,000 (b)",9,10
4249,WMPOW,1833,1527,306,298,1535,E07000235,E10000034,E12000005,47,"Above 1,000 (b)",11,10
4250,WMRCR,1422,1122,300,716,706,E07000193,E10000028,E12000005,41,"Above 1,000 (b)",11,10
4251,WMRID,784,635,149,368,416,E06000019,E99999999,E12000005,00GA,"Below 1,000 (b)",13,10
4252,WMRJ,9110,7930,1180,3838,5272,E07000234,E10000034,E12000005,47,"Above 3,000 (b)",9,10
4253,WMROK,914,711,203,230,684,E07000239,E10000034,E12000005,47,"Below 1,000 (b)",13,10
4254,WMROM,1551,910,641,551,1000,E08000025,E99999999,E12000005,00CN,"Above 1,000 (b)",11,10
4255,WMRUD,381,286,95,116,265,E07000198,E10000028,E12000005,41,"Below 1,000 (b)",13,10
4256,WMRUG,11581,9863,1718,3961,7620,E07000194,E10000028,E12000005,41,"Above 10,000 (b)",7,30
4257,WMSAN,593,270,323,104,489,E07000197,E10000028,E12000005,41,"Below 1,000 (b)",13,10
4258,WMSBH,10112,8801,1311,3437,6675,E06000049,E99999999,E12000002,00EQ,"Above 10,000 (b)",7,30
4259,WMSEI,1890,432,1458,116,1774,E07000197,E10000028,E12000005,41,"Above 1,000 (b)",11,10
4260,WMSEV,508,254,254,122,386,E07000238,E10000034,E12000005,47,"Below 1,000 (b)",13,10
4261,WMSHB,512,259,253,33,479,E07000235,E10000034,E12000005,47,"Below 1,000 (b)",13,10
4262,WMSMA,992,378,614,122,870,E06000049,E99999999,E12000002,00EQ,"Below 1,000 (b)",13,10
4263,WMSPA,25874,15543,10331,4810,21064,E07000197,E10000028,E12000005,41,"Above 20,000 (a)",4,30
4264,WMSPE,569,117,452,56,513,E07000238,E10000034,E12000005,47,"Below 1,000 (a)",12,10
4265,WMSRK,405,346,59,102,303,E07000195,E10000028,E12000005,41,"Below 1,000 (b)",13,10
4266,WMSTA,602,240,362,112,490,E07000238,E10000034,E12000005,47,"Below 1,000 (b)",13,10
4267,WMSTD,3660,3551,109,2487,1173,E07000221,E10000031,E12000005,44,"Above 3,000 (b)",9,10
4268,WMSTJ,9678,9353,325,4753,4925,E07000235,E10000034,E12000005,47,"Above 3,000 (b)",9,10
4269,WMSTK,16662,14443,2219,5916,10746,E07000195,E10000028,E12000005,41,"Above 10,000 (a)",6,30
4270,WMSTO,8497,6778,1719,3212,5285,E07000197,E10000028,E12000005,41,"Above 3,000 (b)",9,10
4271,WMSTP,10657,7161,3496,2441,8216,E07000238,E10000034,E12000005,47,"Above 10,000 (b)",7,30
4272,WMSTU,10688,9235,1453,3942,6746,E07000238,E10000034,E12000005,47,"Above 10,000 (a)",6,30
4273,WMSUC,647,280,367,114,533,E07000235,E10000034,E12000005,47,"Below 1,000 (a)",12,10
4274,WMSWY,555,353,202,257,298,E07000197,E10000028,E12000005,41,"Below 1,000 (b)",13,10
4275,WMTEA,2043,1838,205,1484,559,E07000198,E10000028,E12000005,41,"Above 1,000 (b)",11,10
4276,WMTRE,8912,6430,2482,2051,6861,E07000195,E10000028,E12000005,41,"Above 3,000 (b)",9,10
4277,WMUPS,438,175,263,78,360,E07000235,E10000034,E12000005,47,"Below 1,000 (b)",13,10
4278,WMUSN,763,335,428,168,595,E07000238,E10000034,E12000005,47,"Below 1,000 (b)",13,10
4279,WMUTT,7425,6138,1287,3783,3642,E07000193,E10000028,E12000005,41,"Above 3,000 (b)",9,10
4280,WMUUS,2438,1939,499,1173,1265,E07000238,E10000034,E12000005,47,"Above 1,000 (b)",11,10
4281,WMWAR,486,181,305,66,420,E06000050,E99999999,E12000002,00EW,"Below 1,000 (b)",13,10
4282,WMWAT,740,437,303,251,489,E07000198,E10000028,E12000005,41,"Below 1,000 (b)",13,10
4283,WMWES,1653,593,1060,482,1171,E07000197,E10000028,E12000005,41,"Above 1,000 (b)",11,10
4284,WMWET,570,147,423,59,511,E06000050,E99999999,E12000002,00EW,"Below 1,000 (b)",13,10
4285,WMWHE,1443,1011,432,851,592,E07000196,E10000028,E12000005,41,"Above 1,000 (b)",11,10
4286,WMWHS,4212,3807,405,2898,1314,E07000195,E10000028,E12000005,41,"Above 3,000 (b)",9,10
4287,WMWIC,798,447,351,85,713,E07000235,E10000034,E12000005,47,"Below 1,000 (b)",13,10
4288,WMWLN,10274,8459,1815,2502,7772,E06000049,E99999999,E12000002,00EQ,"Above 10,000 (b)",7,30
4289,WMWLY,3687,3313,374,362,3325,E07000239,E10000034,E12000005,47,"Above 3,000 (b)",9,10
4290,WMWOO,642,408,234,307,335,E07000197,E10000028,E12000005,41,"Below 1,000 (a)",12,10
4291,WMWR,18401,15599,2802,7594,10807,E07000237,E10000034,E12000005,47,"Above 10,000 (a)",6,30
4292,WMWRK,1000,906,94,233,767,E07000198,E10000028,E12000005,41,"Above 1,000 (b)",11,10
4293,WMWTM,981,654,327,395,586,E07000195,E10000028,E12000005,41,"Below 1,000 (b)",13,10
4294,WMWYB,3143,2095,1048,453,2690,E06000049,E99999999,E12000002,00EQ,"Above 3,000 (b)",9,10
4295,WMWYC,1994,1217,777,812,1182,E07000234,E10000034,E12000005,47,"Above 1,000 (b)",11,10
4296,WMYAR,1017,847,170,665,352,E07000197,E10000028,E12000005,41,"Above 1,000 (b)",11,10
4297,WNAB,395,188,207,59,336,E06000051,E99999999,E12000005,00GG,"Below 1,000 (b)",13,10
4298,WNABC,8627,5509,3118,3090,5537,W06000003,W99999999,W99999999,00NE,"Above 3,000 (b)",9,10
4299,WNADR,403,193,210,122,281,W06000002,W99999999,W99999999,00NC,"Below 1,000 (b)",13,10
4300,WNADV,957,826,131,623,334,W06000008,W99999999,W99999999,00NQ,"Below 1,000 (b)",13,10
4301,WNAE,7749,7014,735,3978,3771,W06000008,W99999999,W99999999,00NQ,"Above 3,000 (a)",8,30
4302,WNAF,342,141,201,80,262,E06000050,E99999999,E12000002,00EW,"Below 1,000 (b)",13,10
4303,WNAGE,6776,5403,1373,3891,2885,W06000004,W99999999,W99999999,00NG,"Above 3,000 (b)",9,10
4304,WNAGY,251,189,62,173,78,W06000002,W99999999,W99999999,00NC,"Below 1,000 (b)",13,10
4305,WNAML,2752,1855,897,1366,1386,W06000001,W99999999,W99999999,00NA,"Above 1,000 (b)",11,10
4306,WNAMU,763,447,316,334,429,W06000023,W99999999,W99999999,00NN,"Below 1,000 (a)",12,10
4307,WNASH,1726,1561,165,1090,636,E07000195,E10000028,E12000005,41,"Above 1,000 (b)",11,10
4308,WNASO,1365,1177,188,861,504,W06000002,W99999999,W99999999,00NC,"Above 1,000 (b)",11,10
4309,WNBAL,1467,1197,270,1101,366,W06000002,W99999999,W99999999,00NC,"Above 1,000 (a)",10,10
4310,WNBAR,1517,1370,147,1229,288,W06000002,W99999999,W99999999,00NC,"Above 1,000 (b)",11,10
4311,WNBAS,1476,817,659,623,853,E06000051,E99999999,E12000005,00GG,"Above 1,000 (b)",11,10
4312,WNBC,1962,1214,748,570,1392,E06000019,E99999999,E12000005,00GA,"Above 1,000 (b)",11,10
4313,WNBD,284,132,152,24,260,E06000049,E99999999,E12000002,00EQ,"Below 1,000 (b)",13,10
4314,WNBDM,785,418,367,263,522,E06000019,E99999999,E12000005,00GA,"Below 1,000 (b)",13,10
4315,WNBDO,903,413,490,114,789,W06000001,W99999999,W99999999,00NA,"Below 1,000 (a)",12,10
4316,WNBEA,1166,1097,69,952,214,W06000002,W99999999,W99999999,00NC,"Above 1,000 (b)",11,10
4317,WNBED,449,248,201,156,293,W06000002,W99999999,W99999999,00NC,"Below 1,000 (b)",13,10
4318,WNBEG,357,64,293,29,328,W06000023,W99999999,W99999999,00NN,"Below 1,000 (b)",13,10
4319,WNBER,561,348,213,202,359,W06000023,W99999999,W99999999,00NN,"Below 1,000 (b)",13,10
4320,WNBET,594,257,337,111,483,W06000006,W99999999,W99999999,00NL,"Below 1,000 (b)",13,10
4321,WNBFF,2292,2257,35,1574,718,W06000003,W99999999,W99999999,00NE,"Above 1,000 (b)",11,10
4322,WNBFI,520,297,223,172,348,W06000005,W99999999,W99999999,00NJ,"Below 1,000 (b)",13,10
4323,WNBG,6731,5687,1044,3608,3123,W06000002,W99999999,W99999999,00NC,"Above 3,000 (a)",8,30
4324,WNBGT,608,207,401,78,530,E06000019,E99999999,E12000005,00GA,"Below 1,000 (b)",13,10
4325,WNBH,3989,3537,452,2143,1846,E06000051,E99999999,E12000005,00GG,"Above 3,000 (b)",9,10
4326,WNBIS,1217,1035,182,951,266,W06000023,W99999999,W99999999,00NN,"Above 1,000 (b)",11,10
4327,WNBOD,924,579,345,435,489,W06000006,W99999999,W99999999,00NL,"Below 1,000 (a)",12,10
4328,WNBOM,1016,726,290,585,431,E06000051,E99999999,E12000005,00GG,"Above 1,000 (b)",11,10
4329,WNBON,284,126,158,81,203,W06000002,W99999999,W99999999,00NC,"Below 1,000 (b)",13,10
4330,WNBOR,804,715,89,588,216,W06000008,W99999999,W99999999,00NQ,"Below 1,000 (b)",13,10
4331,WNBOS,574,261,313,47,527,E06000019,E99999999,E12000005,00GA,"Below 1,000 (b)",13,10
4332,WNBOT,485,170,315,84,401,W06000002,W99999999,W99999999,00NC,"Below 1,000 (b)",13,10
4333,WNBRB,582,167,415,52,530,E07000080,E10000013,E12000009,23,"Below 1,000 (b)",13,10
4334,WNBRE,259,131,128,98,161,W06000004,W99999999,W99999999,00NG,"Below 1,000 (b)",13,10
4335,WNBRF,367,133,234,30,337,E06000051,E99999999,E12000005,00GG,"Below 1,000 (b)",13,10
4336,WNBRI,753,139,614,83,670,E06000019,E99999999,E12000005,00GA,"Below 1,000 (b)",13,10
4337,WNBRM,959,425,534,296,663,E06000051,E99999999,E12000005,00GG,"Below 1,000 (b)",13,10
4338,WNBRN,460,130,330,73,387,W06000008,W99999999,W99999999,00NQ,"Below 1,000 (b)",13,10
4339,WNBRS,2340,2213,127,741,1599,E06000051,E99999999,E12000005,00GG,"Above 1,000 (b)",11,10
4340,WNBRX,431,277,154,36,395,E06000050,E99999999,E12000002,00EW,"Below 1,000 (b)",13,10
4341,WNBRY,2677,2340,337,1829,848,E06000019,E99999999,E12000005,00GA,"Above 1,000 (a)",10,10
4342,WNBS,1731,1000,731,608,1123,W06000008,W99999999,W99999999,00NQ,"Above 1,000 (b)",11,10
4343,WNBSN,546,453,93,373,173,W06000002,W99999999,W99999999,00NC,"Below 1,000 (b)",13,10
4344,WNBT,3575,2873,702,1621,1954,W06000002,W99999999,W99999999,00NC,"Above 3,000 (b)",9,10
4345,WNBUC,10001,7730,2271,3937,6064,W06000005,W99999999,W99999999,00NJ,"Above 10,000 (b)",7,30
4346,WNBUK,664,405,259,222,442,W06000023,W99999999,W99999999,00NN,"Below 1,000 (b)",13,10
4347,WNBUN,1220,755,465,547,673,E06000050,E99999999,E12000002,00EW,"Above 1,000 (b)",11,10
4348,WNBUR,1809,622,1187,239,1570,E06000019,E99999999,E12000005,00GA,"Above 1,000 (b)",11,10
4349,WNBW,1915,1509,406,1204,711,W06000023,W99999999,W99999999,00NN,"Above 1,000 (a)",10,10
4350,WNBYC,611,425,186,211,400,W06000003,W99999999,W99999999,00NE,"Below 1,000 (a)",12,10
4351,WNCA,5295,4884,411,3567,1728,W06000002,W99999999,W99999999,00NC,"Above 3,000 (b)",9,10
4352,WNCAG,2949,2267,682,1380,1569,W06000005,W99999999,W99999999,00NJ,"Above 1,000 (b)",11,10
4353,WNCAL,387,204,183,75,312,E06000049,E99999999,E12000002,00EQ,"Below 1,000 (b)",13,10
4354,WNCAW,1106,640,466,438,668,W06000005,W99999999,W99999999,00NJ,"Above 1,000 (b)",11,10
4355,WNCB,4524,4424,100,3348,1176,W06000003,W99999999,W99999999,00NE,"Above 3,000 (a)",8,30
4356,WNCBG,751,315,436,139,612,W06000008,W99999999,W99999999,00NQ,"Below 1,000 (b)",13,10
4357,WNCCA,346,184,162,97,249,W06000023,W99999999,W99999999,00NN,"Below 1,000 (b)",13,10
4358,WNCCG,188,88,100,34,154,W06000003,W99999999,W99999999,00NE,"Below 1,000 (b)",13,10
4359,WNCE,651,352,299,210,441,E06000051,E99999999,E12000005,00GG,"Below 1,000 (b)",13,10
4360,WNCEB,1466,983,483,667,799,W06000001,W99999999,W99999999,00NA,"Above 1,000 (b)",11,10
4361,WNCER,601,93,508,58,543,W06000023,W99999999,W99999999,00NN,"Below 1,000 (b)",13,10
4362,WNCH,704,465,239,343,361,E06000051,E99999999,E12000005,00GG,"Below 1,000 (b)",13,10
4363,WNCHB,300,147,153,107,193,W06000023,W99999999,W99999999,00NN,"Below 1,000 (b)",13,10
4364,WNCHE,533,371,162,268,265,E07000195,E10000028,E12000005,41,"Below 1,000 (b)",13,10
4365,WNCHK,5241,2405,2836,1381,3860,W06000006,W99999999,W99999999,00NL,"Above 3,000 (b)",9,10
4366,WNCHO,409,115,294,55,354,E06000050,E99999999,E12000002,00EW,"Below 1,000 (b)",13,10
4367,WNCHR,6515,4703,1812,923,5592,E06000050,E99999999,E12000002,00EW,"Above 3,000 (b)",9,10
4368,WNCHW,1038,344,694,216,822,W06000002,W99999999,W99999999,00NC,"Above 1,000 (b)",11,10
4369,WNCKO,7487,7374,113,4007,3480,E06000051,E99999999,E12000005,00GG,"Above 3,000 (b)",9,10
4370,WNCLE,1406,785,621,418,988,E06000051,E99999999,E12000005,00GG,"Above 1,000 (b)",11,10
4371,WNCLF,465,209,256,54,411,W06000023,W99999999,W99999999,00NN,"Below 1,000 (b)",13,10
4372,WNCLI,849,390,459,207,642,E06000051,E99999999,E12000005,00GG,"Below 1,000 (b)",13,10
4373,WNCLU,811,460,351,404,407,E06000051,E99999999,E12000005,00GG,"Below 1,000 (b)",13,10
4374,WNCLY,477,211,266,132,345,W06000002,W99999999,W99999999,00NC,"Below 1,000 (b)",13,10
4375,WNCN,569,205,364,92,477,W06000004,W99999999,W99999999,00NG,"Below 1,000 (b)",13,10
4376,WNCOC,758,308,450,232,526,E06000051,E99999999,E12000005,00GG,"Below 1,000 (a)",12,10
4377,WNCOR,1192,717,475,497,695,W06000004,W99999999,W99999999,00NG,"Above 1,000 (a)",10,10
4378,WNCP,878,213,665,117,761,E06000019,E99999999,E12000005,00GA,"Below 1,000 (b)",13,10
4379,WNCRA,1587,1366,221,1255,332,E06000051,E99999999,E12000005,00GG,"Above 1,000 (b)",11,10
4380,WNCRD,408,149,259,60,348,W06000008,W99999999,W99999999,00NQ,"Below 1,000 (b)",13,10
4381,WNCRE,656,371,285,308,348,E06000051,E99999999,E12000005,00GG,"Below 1,000 (a)",12,10
4382,WNCRI,1431,1134,297,850,581,W06000002,W99999999,W99999999,00NC,"Above 1,000 (b)",11,10
4383,WNCRN,505,277,228,181,324,W06000023,W99999999,W99999999,00NN,"Below 1,000 (b)",13,10
4384,WNCRR,474,333,141,183,291,W06000023,W99999999,W99999999,00NN,"Below 1,000 (b)",13,10
4385,WNCRY,590,263,327,61,529,E06000019,E99999999,E12000005,00GA,"Below 1,000 (b)",13,10
4386,WNCSC,12274,10359,1915,4681,7593,E06000050,E99999999,E12000002,00EW,"Above 10,000 (a)",6,30
4387,WNCSK,785,401,384,244,541,W06000023,W99999999,W99999999,00NN,"Below 1,000 (a)",12,10
4388,WNCSN,14893,9359,5534,4961,9932,E06000050,E99999999,E12000002,00EW,"Above 10,000 (a)",6,30
4389,WNCSS,9655,6271,3384,2370,7285,E06000050,E99999999,E12000002,00EW,"Above 3,000 (b)",9,10
4390,WNCST,2711,2389,322,2019,692,E06000051,E99999999,E12000005,00GG,"Above 1,000 (a)",10,10
4391,WNCSW,1167,580,587,469,698,W06000023,W99999999,W99999999,00NN,"Above 1,000 (b)",11,10
4392,WNCYD,562,252,310,216,346,W06000004,W99999999,W99999999,00NG,"Below 1,000 (b)",13,10
4393,WNCYF,244,114,130,76,168,W06000004,W99999999,W99999999,00NG,"Below 1,000 (b)",13,10
4394,WNDAW,8821,8388,433,3424,5397,E06000020,E99999999,E12000005,00GF,"Above 3,000 (b)",9,10
4395,WNDD,748,381,367,101,647,W06000006,W99999999,W99999999,00NL,"Below 1,000 (b)",13,10
4396,WNDEE,12635,7980,4655,3053,9582,W06000005,W99999999,W99999999,00NJ,"Above 10,000 (a)",6,30
4397,WNDEN,4682,4218,464,2933,1749,W06000004,W99999999,W99999999,00NG,"Above 3,000 (a)",8,30
4398,WNDH,1327,478,849,287,1040,E06000051,E99999999,E12000005,00GG,"Above 1,000 (b)",11,10
4399,WNDLE,314,245,69,60,254,W06000003,W99999999,W99999999,00NE,"Below 1,000 (b)",13,10
4400,WNDLG,619,359,260,209,410,W06000003,W99999999,W99999999,00NE,"Below 1,000 (b)",13,10
4401,WNDLN,1017,88,929,24,993,W06000003,W99999999,W99999999,00NE,"Above 1,000 (b)",11,10
4402,WNDM,400,150,250,108,292,W06000023,W99999999,W99999999,00NN,"Below 1,000 (b)",13,10
4403,WNDOL,1871,1560,311,1429,442,W06000002,W99999999,W99999999,00NC,"Above 1,000 (a)",10,10
4404,WNDON,8171,7408,763,2894,5277,E06000051,E99999999,E12000005,00GG,"Above 3,000 (b)",9,10
4405,WNDOR,900,463,437,306,594,E06000051,E99999999,E12000005,00GG,"Below 1,000 (b)",13,10
4406,WNDYF,839,800,39,500,339,W06000002,W99999999,W99999999,00NC,"Below 1,000 (b)",13,10
4407,WNDYS,2007,1584,423,1005,1002,W06000005,W99999999,W99999999,00NJ,"Above 1,000 (b)",11,10
4408,WNEAR,817,341,476,262,555,E06000019,E99999999,E12000005,00GA,"Below 1,000 (b)",13,10
4409,WNELL,2497,2148,349,1526,971,W06000006,W99999999,W99999999,00NL,"Above 1,000 (b)",11,10
4410,WNERD,591,352,239,157,434,E06000051,E99999999,E12000005,00GG,"Below 1,000 (b)",13,10
4411,WNERW,361,152,209,48,313,W06000023,W99999999,W99999999,00NN,"Below 1,000 (b)",13,10
4412,WNFAI,982,557,425,436,546,W06000002,W99999999,W99999999,00NC,"Below 1,000 (b)",13,10
4413,WNFAR,1633,1462,171,1149,484,E06000050,E99999999,E12000002,00EW,"Above 1,000 (a)",10,10
4414,WNFF,510,451,59,394,116,W06000002,W99999999,W99999999,00NC,"Below 1,000 (b)",13,10
4415,WNFL,6056,5049,1007,3041,3015,W06000005,W99999999,W99999999,00NJ,"Above 3,000 (a)",8,30
4416,WNFOR,553,393,160,242,311,W06000023,W99999999,W99999999,00NN,"Below 1,000 (b)",13,10
4417,WNFOW,805,481,324,389,416,E06000019,E99999999,E12000005,00GA,"Below 1,000 (b)",13,10
4418,WNGAE,1377,890,487,550,827,W06000001,W99999999,W99999999,00NA,"Above 1,000 (b)",11,10
4419,WNGB,868,304,564,139,729,E06000051,E99999999,E12000005,00GG,"Below 1,000 (b)",13,10
4420,WNGCW,609,145,464,40,569,E07000196,E10000028,E12000005,41,"Below 1,000 (b)",13,10
4421,WNGD,504,187,317,29,475,W06000002,W99999999,W99999999,00NC,"Below 1,000 (b)",13,10
4422,WNGDR,381,168,213,70,311,W06000004,W99999999,W99999999,00NG,"Below 1,000 (b)",13,10
4423,WNGLA,297,60,237,12,285,W06000023,W99999999,W99999999,00NN,"Below 1,000 (b)",13,10
4424,WNGLB,755,419,336,229,526,W06000023,W99999999,W99999999,00NN,"Below 1,000 (b)",13,10
4425,WNGLC,878,611,267,134,744,W06000023,W99999999,W99999999,00NN,"Below 1,000 (b)",13,10
4426,WNGLW,197,59,138,29,168,W06000002,W99999999,W99999999,00NC,"Below 1,000 (b)",13,10
4427,WNGM,3937,889,3048,162,3775,E06000050,E99999999,E12000002,00EW,"Above 3,000 (b)",9,10
4428,WNGND,287,119,168,61,226,W06000023,W99999999,W99999999,00NN,"Below 1,000 (b)",13,10
4429,WNGOR,685,450,235,206,479,E07000080,E10000013,E12000009,23,"Below 1,000 (a)",12,10
4430,WNGRE,6592,4325,2267,1505,5087,W06000006,W99999999,W99999999,00NL,"Above 3,000 (b)",9,10
4431,WNGUI,932,659,273,578,354,W06000023,W99999999,W99999999,00NN,"Below 1,000 (a)",12,10
4432,WNGW,1308,469,839,371,937,W06000001,W99999999,W99999999,00NA,"Above 1,000 (b)",11,10
4433,WNHAD,560,423,137,270,290,E06000051,E99999999,E12000005,00GG,"Below 1,000 (b)",13,10
4434,WNHAE,369,143,226,46,323,E06000019,E99999999,E12000005,00GA,"Below 1,000 (b)",13,10
4435,WNHAL,1467,938,529,255,1212,W06000005,W99999999,W99999999,00NJ,"Above 1,000 (b)",11,10
4436,WNHAM,605,364,241,267,338,E06000050,E99999999,E12000002,00EW,"Below 1,000 (b)",13,10
4437,WNHAN,1331,612,719,212,1119,E06000051,E99999999,E12000005,00GG,"Above 1,000 (b)",11,10
4438,WNHAR,1228,1013,215,679,549,W06000002,W99999999,W99999999,00NC,"Above 1,000 (b)",11,10
4439,WNHAT,9119,8233,886,3620,5499,E06000051,E99999999,E12000005,00GG,"Above 3,000 (b)",9,10
4440,WNHAW,5821,4577,1244,1455,4366,W06000005,W99999999,W99999999,00NJ,"Above 3,000 (b)",9,10
4441,WNHAY,1764,1327,437,1206,558,W06000023,W99999999,W99999999,00NN,"Above 1,000 (a)",10,10
4442,WNHCP,264,146,118,46,218,E06000019,E99999999,E12000005,00GA,"Below 1,000 (b)",13,10
4443,WNHER,905,488,417,353,552,E06000051,E99999999,E12000005,00GG,"Below 1,000 (b)",13,10
4444,WNHH,951,256,695,114,837,W06000023,W99999999,W99999999,00NN,"Below 1,000 (b)",13,10
4445,WNHL,640,185,455,124,516,E06000019,E99999999,E12000005,00GA,"Below 1,000 (b)",13,10
4446,WNHLN,4603,4413,190,2173,2430,E06000051,E99999999,E12000005,00GG,"Above 3,000 (b)",9,10
4447,WNHMR,781,253,528,106,675,W06000006,W99999999,W99999999,00NL,"Below 1,000 (b)",13,10
4448,WNHOD,720,413,307,214,506,E06000051,E99999999,E12000005,00GG,"Below 1,000 (b)",13,10
4449,WNHOL,5941,5866,75,4667,1274,W06000001,W99999999,W99999999,00NA,"Above 3,000 (a)",8,30
4450,WNHR,28947,19028,9919,5310,23637,E06000019,E99999999,E12000005,00GA,"Above 20,000 (b)",5,30
4451,WNHUN,295,131,164,10,285,W06000023,W99999999,W99999999,00NN,"Below 1,000 (b)",13,10
4452,WNHUX,600,410,190,31,569,E06000050,E99999999,E12000002,00EW,"Below 1,000 (b)",13,10
4453,WNHW,6474,4177,2297,1985,4489,W06000005,W99999999,W99999999,00NJ,"Above 3,000 (b)",9,10
4454,WNIB,3301,3042,259,644,2657,E06000051,E99999999,E12000005,00GG,"Above 3,000 (b)",9,10
4455,WNIV,414,137,277,27,387,E06000019,E99999999,E12000005,00GA,"Below 1,000 (b)",13,10
4456,WNKEL,2091,1698,393,802,1289,E06000050,E99999999,E12000002,00EW,"Above 1,000 (b)",11,10
4457,WNKER,763,473,290,62,701,W06000023,W99999999,W99999999,00NN,"Below 1,000 (b)",13,10
4458,WNKIN,1832,1591,241,1423,409,W06000023,W99999999,W99999999,00NN,"Above 1,000 (b)",11,10
4459,WNKNG,703,446,257,327,376,E06000019,E99999999,E12000005,00GA,"Below 1,000 (b)",13,10
4460,WNKNI,1870,1575,295,1487,383,W06000023,W99999999,W99999999,00NN,"Above 1,000 (a)",10,10
4461,WNKNO,821,379,442,92,729,W06000023,W99999999,W99999999,00NN,"Below 1,000 (b)",13,10
4462,WNKT,3920,3213,707,64,3856,E06000050,E99999999,E12000002,00EW,"Above 3,000 (a)",8,30
4463,WNKYR,389,104,285,35,354,E07000235,E10000034,E12000005,47,"Below 1,000 (b)",13,10
4464,WNLAD,1112,778,334,504,608,W06000001,W99999999,W99999999,00NA,"Above 1,000 (a)",10,10
4465,WNLAN,429,245,184,191,238,W06000003,W99999999,W99999999,00NE,"Below 1,000 (a)",12,10
4466,WNLAR,849,370,479,313,536,W06000008,W99999999,W99999999,00NQ,"Below 1,000 (a)",12,10
4467,WNLBD,429,133,296,21,408,E06000051,E99999999,E12000005,00GG,"Below 1,000 (b)",13,10
4468,WNLBG,1120,778,342,468,652,W06000002,W99999999,W99999999,00NC,"Above 1,000 (b)",11,10
4469,WNLBH,274,137,137,45,229,E06000051,E99999999,E12000005,00GG,"Below 1,000 (b)",13,10
4470,WNLBR,468,365,103,266,202,W06000002,W99999999,W99999999,00NC,"Below 1,000 (b)",13,10
4471,WNLBW,7618,270,7348,133,7485,E06000050,E99999999,E12000002,00EW,"Above 3,000 (b)",9,10
4472,WNLC,1087,570,517,452,635,W06000023,W99999999,W99999999,00NN,"Above 1,000 (b)",11,10
4473,WNLDA,501,190,311,27,474,W06000006,W99999999,W99999999,00NL,"Below 1,000 (b)",13,10
4474,WNLDC,208,69,139,48,160,W06000023,W99999999,W99999999,00NN,"Below 1,000 (b)",13,10
4475,WNLDD,9210,8441,769,5227,3983,W06000003,W99999999,W99999999,00NE,"Above 3,000 (a)",8,30
4476,WNLDF,322,192,130,147,175,W06000002,W99999999,W99999999,00NC,"Below 1,000 (b)",13,10
4477,WNLDG,729,443,286,309,420,W06000004,W99999999,W99999999,00NG,"Below 1,000 (b)",13,10
4478,WNLDO,363,243,120,210,153,W06000004,W99999999,W99999999,00NG,"Below 1,000 (b)",13,10
4479,WNLEA,982,547,435,216,766,E07000080,E10000013,E12000009,23,"Below 1,000 (b)",13,10
4480,WNLED,4884,4544,340,4078,806,E06000019,E99999999,E12000005,00GA,"Above 3,000 (a)",8,30
4481,WNLEI,604,391,213,319,285,E06000051,E99999999,E12000005,00GG,"Below 1,000 (b)",13,10
4482,WNLEO,6002,5761,241,4393,1609,E06000019,E99999999,E12000005,00GA,"Above 3,000 (b)",9,10
4483,WNLEY,383,136,247,38,345,E07000235,E10000034,E12000005,47,"Below 1,000 (b)",13,10
4484,WNLFF,1886,1759,127,1385,501,W06000003,W99999999,W99999999,00NE,"Above 1,000 (a)",10,10
4485,WNLFN,927,663,264,579,348,W06000023,W99999999,W99999999,00NN,"Below 1,000 (b)",13,10
4486,WNLFS,626,172,454,49,577,W06000005,W99999999,W99999999,00NJ,"Below 1,000 (b)",13,10
4487,WNLFU,949,264,685,145,804,W06000001,W99999999,W99999999,00NA,"Below 1,000 (b)",13,10
4488,WNLGD,588,147,441,22,566,W06000023,W99999999,W99999999,00NN,"Below 1,000 (b)",13,10
4489,WNLGF,3408,2593,815,1830,1578,W06000001,W99999999,W99999999,00NA,"Above 3,000 (b)",9,10
4490,WNLGG,272,122,150,93,179,W06000023,W99999999,W99999999,00NN,"Below 1,000 (b)",13,10
4491,WNLGL,351,83,268,30,321,W06000023,W99999999,W99999999,00NN,"Below 1,000 (b)",13,10
4492,WNLGN,604,294,310,84,520,E06000019,E99999999,E12000005,00GA,"Below 1,000 (b)",13,10
4493,WNLGO,587,210,377,80,507,W06000008,W99999999,W99999999,00NQ,"Below 1,000 (b)",13,10
4494,WNLGW,527,124,403,82,445,W06000023,W99999999,W99999999,00NN,"Below 1,000 (b)",13,10
4495,WNLGY,504,226,278,171,333,W06000003,W99999999,W99999999,00NE,"Below 1,000 (b)",13,10
4496,WNLIN,363,100,263,0,363,E06000051,E99999999,E12000005,00GG,"Below 1,000 (b)",13,10
4497,WNLIT,539,253,286,127,412,E06000051,E99999999,E12000005,00GG,"Below 1,000 (a)",12,10
4498,WNLMD,1090,539,551,417,673,W06000001,W99999999,W99999999,00NA,"Above 1,000 (b)",11,10
4499,WNLMR,496,167,329,104,392,W06000023,W99999999,W99999999,00NN,"Below 1,000 (a)",12,10
4500,WNLMY,2435,1063,1372,566,1869,W06000023,W99999999,W99999999,00NN,"Above 1,000 (b)",11,10
4501,WNLN,2157,1793,364,985,1172,W06000006,W99999999,W99999999,00NL,"Above 1,000 (b)",11,10
4502,WNLNF,367,117,250,69,298,W06000004,W99999999,W99999999,00NG,"Below 1,000 (b)",13,10
4503,WNLNO,480,95,385,10,470,W06000023,W99999999,W99999999,00NN,"Below 1,000 (b)",13,10
4504,WNLNS,2104,1684,420,1459,645,W06000023,W99999999,W99999999,00NN,"Above 1,000 (b)",11,10
4505,WNLNY,439,312,127,194,245,W06000004,W99999999,W99999999,00NG,"Below 1,000 (b)",13,10
4506,WNLON,901,625,276,17,884,W06000008,W99999999,W99999999,00NQ,"Below 1,000 (b)",13,10
4507,WNLR,3823,1004,2819,256,3567,W06000002,W99999999,W99999999,00NC,"Above 3,000 (b)",9,10
4508,WNLRD,510,366,144,264,246,W06000023,W99999999,W99999999,00NN,"Below 1,000 (a)",12,10
4509,WNLSF,1021,561,460,432,589,W06000023,W99999999,W99999999,00NN,"Above 1,000 (b)",11,10
4510,WNLSN,495,170,325,106,389,W06000023,W99999999,W99999999,00NN,"Below 1,000 (b)",13,10
4511,WNLST,2438,1926,512,1460,978,W06000003,W99999999,W99999999,00NE,"Above 1,000 (a)",10,10
4512,WNLTH,354,272,82,225,129,W06000003,W99999999,W99999999,00NE,"Below 1,000 (b)",13,10
4513,WNLTN,961,239,722,174,787,W06000002,W99999999,W99999999,00NC,"Below 1,000 (b)",13,10
4514,WNLU,441,257,184,182,259,W06000002,W99999999,W99999999,00NC,"Below 1,000 (b)",13,10
4515,WNLUD,6128,5903,225,4420,1708,E06000051,E99999999,E12000005,00GG,"Above 3,000 (a)",8,30
4516,WNLVL,480,101,379,38,442,E06000051,E99999999,E12000005,00GG,"Below 1,000 (b)",13,10
4517,WNLW,3455,3059,396,2241,1214,W06000023,W99999999,W99999999,00NN,"Above 3,000 (a)",8,30
4518,WNLWA,1752,825,927,140,1612,W06000002,W99999999,W99999999,00NC,"Above 1,000 (b)",11,10
4519,WNLWN,305,110,195,83,222,W06000023,W99999999,W99999999,00NN,"Below 1,000 (b)",13,10
4520,WNLWW,588,377,211,341,247,W06000023,W99999999,W99999999,00NN,"Below 1,000 (b)",13,10
4521,WNLYD,327,172,155,130,197,E06000051,E99999999,E12000005,00GG,"Below 1,000 (b)",13,10
4522,WNLYI,356,234,122,136,220,W06000005,W99999999,W99999999,00NJ,"Below 1,000 (b)",13,10
4523,WNLYO,518,260,258,149,369,E06000019,E99999999,E12000005,00GA,"Below 1,000 (b)",13,10
4524,WNM,8319,6185,2134,3928,4391,W06000005,W99999999,W99999999,00NJ,"Above 3,000 (a)",8,30
4525,WNMAC,1590,1285,305,1148,442,W06000023,W99999999,W99999999,00NN,"Above 1,000 (a)",10,10
4526,WNMAN,355,163,192,98,257,W06000002,W99999999,W99999999,00NC,"Below 1,000 (b)",13,10
4527,WNMAP,1130,1007,123,780,350,E06000050,E99999999,E12000002,00EW,"Above 1,000 (b)",11,10
4528,WNMAR,454,134,320,40,414,W06000004,W99999999,W99999999,00NG,"Below 1,000 (b)",13,10
4529,WNMB,4936,3248,1688,1657,3279,W06000002,W99999999,W99999999,00NC,"Above 3,000 (b)",9,10
4530,WNMD,6086,5712,374,3235,2851,E07000195,E10000028,E12000005,41,"Above 3,000 (b)",9,10
4531,WNMDL,1863,450,1413,330,1533,E06000019,E99999999,E12000005,00GA,"Above 1,000 (b)",11,10
4532,WNMEI,595,274,321,207,388,W06000023,W99999999,W99999999,00NN,"Below 1,000 (b)",13,10
4533,WNMFB,477,72,405,19,458,E06000051,E99999999,E12000005,00GG,"Below 1,000 (b)",13,10
4534,WNMIC,340,96,244,30,310,W06000023,W99999999,W99999999,00NN,"Below 1,000 (b)",13,10
4535,WNMM,423,229,194,101,322,E07000080,E10000013,E12000009,23,"Below 1,000 (b)",13,10
4536,WNMOC,596,81,515,48,548,E06000019,E99999999,E12000005,00GA,"Below 1,000 (a)",12,10
4537,WNMOE,936,713,223,253,683,W06000001,W99999999,W99999999,00NA,"Below 1,000 (b)",13,10
4538,WNMON,794,508,286,37,757,W06000023,W99999999,W99999999,00NN,"Below 1,000 (b)",13,10
4539,WNMOS,2243,766,1477,561,1682,W06000005,W99999999,W99999999,00NJ,"Above 1,000 (b)",11,10
4540,WNMSB,348,128,220,27,321,E06000051,E99999999,E12000005,00GG,"Below 1,000 (b)",13,10
4541,WNMSL,349,151,198,55,294,E06000051,E99999999,E12000005,00GG,"Below 1,000 (b)",13,10
4542,WNMT,1564,921,643,627,937,E06000050,E99999999,E12000002,00EW,"Above 1,000 (b)",11,10
4543,WNMUC,1471,1278,193,1102,369,E06000051,E99999999,E12000005,00GG,"Above 1,000 (b)",11,10
4544,WNMUN,528,115,413,50,478,E06000019,E99999999,E12000005,00GA,"Below 1,000 (b)",13,10
4545,WNMW,1400,325,1075,148,1252,W06000005,W99999999,W99999999,00NJ,"Above 1,000 (b)",11,10
4546,WNNAN,413,162,251,25,388,W06000004,W99999999,W99999999,00NG,"Below 1,000 (b)",13,10
4547,WNNBG,515,281,234,115,400,E06000051,E99999999,E12000005,00GG,"Below 1,000 (b)",13,10
4548,WNNBR,1080,481,599,384,696,W06000001,W99999999,W99999999,00NA,"Above 1,000 (b)",11,10
4549,WNNCL,518,315,203,65,453,E06000051,E99999999,E12000005,00GG,"Below 1,000 (b)",13,10
4550,WNNEB,575,186,389,80,495,W06000008,W99999999,W99999999,00NQ,"Below 1,000 (b)",13,10
4551,WNNEF,1833,1344,489,550,1283,W06000002,W99999999,W99999999,00NC,"Above 1,000 (b)",11,10
4552,WNNN,6046,4138,1908,2466,3580,W06000023,W99999999,W99999999,00NN,"Above 3,000 (a)",8,30
4553,WNNOR,259,160,99,66,193,E06000051,E99999999,E12000005,00GG,"Below 1,000 (b)",13,10
4554,WNNOW,1029,379,650,336,693,W06000023,W99999999,W99999999,00NN,"Above 1,000 (b)",11,10
4555,WNNP,7212,6270,942,4829,2383,E06000051,E99999999,E12000005,00GG,"Above 3,000 (b)",9,10
4556,WNNR,462,173,289,142,320,W06000023,W99999999,W99999999,00NN,"Below 1,000 (b)",13,10
4557,WNNTP,2160,942,1218,481,1679,W06000005,W99999999,W99999999,00NJ,"Above 1,000 (b)",11,10
4558,WNOAK,12107,10968,1139,3526,8581,E06000020,E99999999,E12000005,00GF,"Above 10,000 (b)",7,30
4559,WNOC,5308,4519,789,2565,2743,W06000003,W99999999,W99999999,00NE,"Above 3,000 (b)",9,10
4560,WNOOD,841,582,259,461,380,W06000006,W99999999,W99999999,00NL,"Below 1,000 (b)",13,10
4561,WNOSW,11888,9230,2658,4771,7117,E06000051,E99999999,E12000005,00GG,"Above 10,000 (a)",6,30
4562,WNPAI,282,93,189,52,230,W06000023,W99999999,W99999999,00NN,"Below 1,000 (b)",13,10
4563,WNPAN,345,120,225,25,320,W06000023,W99999999,W99999999,00NN,"Below 1,000 (b)",13,10
4564,WNPBK,2166,1114,1052,877,1289,W06000005,W99999999,W99999999,00NJ,"Above 1,000 (b)",11,10
4565,WNPCH,670,465,205,372,298,E06000019,E99999999,E12000005,00GA,"Below 1,000 (b)",13,10
4566,WNPCO,422,162,260,109,313,E06000019,E99999999,E12000005,00GA,"Below 1,000 (b)",13,10
4567,WNPDD,1545,1080,465,819,726,W06000002,W99999999,W99999999,00NC,"Above 1,000 (b)",11,10
4568,WNPEB,676,345,331,221,455,W06000023,W99999999,W99999999,00NN,"Below 1,000 (b)",13,10
4569,WNPEF,320,150,170,89,231,W06000003,W99999999,W99999999,00NE,"Below 1,000 (b)",13,10
4570,WNPEG,2470,1782,688,1008,1462,W06000002,W99999999,W99999999,00NC,"Above 1,000 (b)",11,10
4571,WNPEM,1046,362,684,258,788,E06000019,E99999999,E12000005,00GA,"Above 1,000 (b)",11,10
4572,WNPEN,2169,1640,529,1313,856,W06000003,W99999999,W99999999,00NE,"Above 1,000 (b)",11,10
4573,WNPG,1648,1102,546,1014,634,W06000023,W99999999,W99999999,00NN,"Above 1,000 (a)",10,10
4574,WNPIP,945,650,295,304,641,E06000049,E99999999,E12000002,00EQ,"Below 1,000 (b)",13,10
4575,WNPMN,481,293,188,240,241,W06000003,W99999999,W99999999,00NE,"Below 1,000 (b)",13,10
4576,WNPNL,235,192,43,119,116,W06000023,W99999999,W99999999,00NN,"Below 1,000 (b)",13,10
4577,WNPNN,531,206,325,156,375,W06000023,W99999999,W99999999,00NN,"Below 1,000 (b)",13,10
4578,WNPNR,894,620,274,431,463,W06000001,W99999999,W99999999,00NA,"Below 1,000 (b)",13,10
4579,WNPON,2191,1301,890,643,1548,E06000051,E99999999,E12000005,00GG,"Above 1,000 (a)",10,10
4580,WNPOR,2826,2231,595,1369,1457,W06000002,W99999999,W99999999,00NC,"Above 1,000 (b)",11,10
4581,WNPRD,471,298,173,211,260,W06000008,W99999999,W99999999,00NQ,"Below 1,000 (b)",13,10
4582,WNPRE,1362,620,742,452,910,E06000051,E99999999,E12000005,00GG,"Above 1,000 (b)",11,10
4583,WNPRG,393,192,201,63,330,W06000008,W99999999,W99999999,00NQ,"Below 1,000 (b)",13,10
4584,WNPRL,937,509,428,102,835,W06000021,W99999999,W99999999,00PP,"Below 1,000 (b)",13,10
4585,WNPRS,9929,8370,1559,4455,5474,W06000005,W99999999,W99999999,00NJ,"Above 3,000 (b)",9,10
4586,WNPTD,1992,1326,666,1022,970,W06000002,W99999999,W99999999,00NC,"Above 1,000 (b)",11,10
4587,WNPTW,425,85,340,7,418,W06000008,W99999999,W99999999,00NQ,"Below 1,000 (b)",13,10
4588,WNPWL,2736,2290,446,1478,1258,W06000002,W99999999,W99999999,00NC,"Above 1,000 (a)",10,10
4589,WNQH,986,528,458,74,912,E06000051,E99999999,E12000005,00GG,"Below 1,000 (b)",13,10
4590,WNRAY,1494,1090,404,1040,454,W06000023,W99999999,W99999999,00NN,"Above 1,000 (b)",11,10
4591,WNRC,358,198,160,35,323,E06000051,E99999999,E12000005,00GG,"Below 1,000 (b)",13,10
4592,WNRE,14785,10386,4399,4444,10341,W06000004,W99999999,W99999999,00NG,"Above 10,000 (a)",6,30
4593,WNRHD,264,95,169,53,211,W06000002,W99999999,W99999999,00NC,"Below 1,000 (b)",13,10
4594,WNRHU,3539,2360,1179,1795,1744,W06000004,W99999999,W99999999,00NG,"Above 3,000 (b)",9,10
4595,WNRIW,203,130,73,73,130,W06000002,W99999999,W99999999,00NC,"Below 1,000 (b)",13,10
4596,WNRM,477,163,314,53,424,E06000050,E99999999,E12000002,00EW,"Below 1,000 (b)",13,10
4597,WNRNR,1344,996,348,802,542,W06000001,W99999999,W99999999,00NA,"Above 1,000 (b)",11,10
4598,WNROS,7444,5518,1926,3794,3650,W06000003,W99999999,W99999999,00NE,"Above 3,000 (a)",8,30
4599,WNROW,6776,5856,920,3633,3143,E06000019,E99999999,E12000005,00GA,"Above 3,000 (a)",8,30
4600,WNRST,1770,1483,287,868,902,E06000050,E99999999,E12000002,00EW,"Above 1,000 (b)",11,10
4601,WNRUA,5960,3050,2910,1494,4466,W06000006,W99999999,W99999999,00NL,"Above 3,000 (b)",9,10
4602,WNRUT,4014,3030,984,2326,1688,W06000004,W99999999,W99999999,00NG,"Above 3,000 (a)",8,30
4603,WNRWX,6328,6052,276,3908,2420,W06000006,W99999999,W99999999,00NL,"Above 3,000 (b)",9,10
4604,WNRYT,311,237,74,99,212,E07000196,E10000028,E12000005,41,"Below 1,000 (b)",13,10
4605,WNSA,2105,1772,333,1568,537,W06000004,W99999999,W99999999,00NG,"Above 1,000 (b)",11,10
4606,WNSAM,625,218,407,93,532,E06000051,E99999999,E12000005,00GG,"Below 1,000 (b)",13,10
4607,WNSAU,3116,1536,1580,1205,1911,E06000050,E99999999,E12000002,00EW,"Above 3,000 (b)",9,10
4608,WNSEA,620,274,346,70,550,E06000050,E99999999,E12000002,00EW,"Below 1,000 (b)",13,10
4609,WNSEI,377,164,213,42,335,E06000051,E99999999,E12000005,00GG,"Below 1,000 (b)",13,10
4610,WNSHA,1304,1040,264,859,445,E06000051,E99999999,E12000005,00GG,"Above 1,000 (b)",11,10
4611,WNSHI,3511,3375,136,3063,448,E06000051,E99999999,E12000005,00GG,"Above 3,000 (a)",8,30
4612,WNSSM,374,112,262,48,326,E06000051,E99999999,E12000005,00GG,"Below 1,000 (b)",13,10
4613,WNSSN,1435,516,919,315,1120,E06000019,E99999999,E12000005,00GA,"Above 1,000 (b)",11,10
4614,WNSTE,532,213,319,65,467,E06000019,E99999999,E12000005,00GA,"Below 1,000 (b)",13,10
4615,WNSTI,8110,8081,29,3907,4203,E06000051,E99999999,E12000005,00GG,"Above 3,000 (b)",9,10
4616,WNSW,329,140,189,47,282,E06000019,E99999999,E12000005,00GA,"Below 1,000 (b)",13,10
4617,WNSY,24669,17560,7109,6250,18419,E06000051,E99999999,E12000005,00GG,"Above 20,000 (a)",4,30
4618,WNTAL,776,476,300,320,456,W06000008,W99999999,W99999999,00NQ,"Below 1,000 (b)",13,10
4619,WNTAR,2075,1633,442,1267,808,E06000050,E99999999,E12000002,00EW,"Above 1,000 (a)",10,10
4620,WNTFG,499,201,298,89,410,W06000023,W99999999,W99999999,00NN,"Below 1,000 (b)",13,10
4621,WNTH,904,536,368,350,554,E06000051,E99999999,E12000005,00GG,"Below 1,000 (b)",13,10
4622,WNTHL,1394,977,417,173,1221,E06000050,E99999999,E12000002,00EW,"Above 1,000 (b)",11,10
4623,WNTHR,591,294,297,114,477,E06000050,E99999999,E12000002,00EW,"Below 1,000 (b)",13,10
4624,WNTIL,524,406,118,288,236,E06000050,E99999999,E12000002,00EW,"Below 1,000 (b)",13,10
4625,WNTRA,468,376,92,336,132,W06000002,W99999999,W99999999,00NC,"Below 1,000 (b)",13,10
4626,WNTRB,1252,1132,120,662,590,W06000001,W99999999,W99999999,00NA,"Above 1,000 (b)",11,10
4627,WNTRG,891,538,353,500,391,W06000008,W99999999,W99999999,00NQ,"Below 1,000 (b)",13,10
4628,WNTRN,804,662,142,542,262,W06000004,W99999999,W99999999,00NG,"Below 1,000 (a)",12,10
4629,WNTRR,600,261,339,172,428,E06000019,E99999999,E12000005,00GA,"Below 1,000 (b)",13,10
4630,WNTRU,386,161,225,41,345,E06000019,E99999999,E12000005,00GA,"Below 1,000 (b)",13,10
4631,WNTRW,877,294,583,216,661,W06000023,W99999999,W99999999,00NN,"Below 1,000 (b)",13,10
4632,WNTRY,847,329,518,285,562,W06000023,W99999999,W99999999,00NN,"Below 1,000 (b)",13,10
4633,WNTUD,459,72,387,17,442,W06000002,W99999999,W99999999,00NC,"Below 1,000 (b)",13,10
4634,WNTV,1767,1417,350,1191,576,E06000050,E99999999,E12000002,00EW,"Above 1,000 (b)",11,10
4635,WNTW,2380,2086,294,1314,1066,E06000051,E99999999,E12000005,00GG,"Above 1,000 (b)",11,10
4636,WNTYG,1073,419,654,178,895,W06000003,W99999999,W99999999,00NE,"Above 1,000 (b)",11,10
4637,WNTYN,1891,1634,257,1352,539,W06000001,W99999999,W99999999,00NA,"Above 1,000 (b)",11,10
4638,WNTYW,2448,1908,540,1610,838,W06000002,W99999999,W99999999,00NC,"Above 1,000 (b)",11,10
4639,WNUB,430,267,163,142,288,E06000019,E99999999,E12000005,00GA,"Below 1,000 (b)",13,10
4640,WNUM,440,162,278,115,325,E06000051,E99999999,E12000005,00GG,"Below 1,000 (b)",13,10
4641,WNUP,318,114,204,32,286,E06000051,E99999999,E12000005,00GG,"Below 1,000 (b)",13,10
4642,WNVAL,2690,1477,1213,758,1932,W06000001,W99999999,W99999999,00NA,"Above 1,000 (b)",11,10
4643,WNWA,1029,441,588,21,1008,W06000002,W99999999,W99999999,00NC,"Above 1,000 (b)",11,10
4644,WNWCH,5316,4778,538,4093,1223,E06000050,E99999999,E12000002,00EW,"Above 3,000 (b)",9,10
4645,WNWEL,15655,10906,4749,4903,10752,E06000020,E99999999,E12000005,00GF,"Above 10,000 (a)",6,30
4646,WNWEM,3471,3249,222,2593,878,E06000051,E99999999,E12000005,00GG,"Above 3,000 (a)",8,30
4647,WNWEO,1081,665,416,569,512,E06000019,E99999999,E12000005,00GA,"Above 1,000 (b)",11,10
4648,WNWET,319,211,108,59,260,E06000051,E99999999,E12000005,00GG,"Below 1,000 (b)",13,10
4649,WNWIG,586,327,259,279,307,E06000019,E99999999,E12000005,00GA,"Below 1,000 (b)",13,10
4650,WNWIT,397,73,324,8,389,W06000023,W99999999,W99999999,00NN,"Below 1,000 (b)",13,10
4651,WNWOM,465,165,300,74,391,E06000019,E99999999,E12000005,00GA,"Below 1,000 (b)",13,10
4652,WNWOR,1049,608,441,235,814,E06000019,E99999999,E12000005,00GA,"Above 1,000 (b)",11,10
4653,WNWPL,3474,3239,235,2647,827,W06000023,W99999999,W99999999,00NN,"Above 3,000 (a)",8,30
4654,WNWTN,762,313,449,220,542,E06000051,E99999999,E12000005,00GG,"Below 1,000 (b)",13,10
4655,WNWUL,383,206,177,23,360,E07000196,E10000028,E12000005,41,"Below 1,000 (b)",13,10
4656,WNWX,21262,16196,5066,5335,15927,W06000006,W99999999,W99999999,00NL,"Above 20,000 (a)",4,30
4657,WNWXL,603,328,275,166,437,W06000006,W99999999,W99999999,00NL,"Below 1,000 (b)",13,10
4658,WNWXN,11838,7005,4833,2193,9645,W06000005,W99999999,W99999999,00NJ,"Above 10,000 (b)",7,30
4659,WNYA,742,290,452,165,577,E06000019,E99999999,E12000005,00GA,"Below 1,000 (b)",13,10
4660,WNYO,662,207,455,133,529,E06000051,E99999999,E12000005,00GG,"Below 1,000 (b)",13,10
4661,WRBATT,20911,20911,0,15929,4982,E09000022,E99999999,E12000007,00London,Inner London,1,50
4662,WRBEL,4301,4301,0,4301,0,E09000033,E99999999,E12000007,00London,Inner London,1,50
4663,WRBRIX,29605,29605,0,16433,13172,E09000028,E99999999,E12000007,00London,Inner London,1,50
4664,WRCHEL,12069,12069,0,9493,2576,E09000032,E99999999,E12000007,00London,Inner London,1,50
4665,WRECT,7705,7705,0,7608,97,E09000013,E99999999,E12000007,00London,Inner London,1,50
4666,WRFULM,16911,16911,0,14660,2251,E09000013,E99999999,E12000007,00London,Inner London,1,50
4667,WRKGDN,8008,8008,0,8005,3,E09000033,E99999999,E12000007,00London,Inner London,1,50
4668,WRNELMS,21187,21187,0,13895,7292,E09000022,E99999999,E12000007,00London,Inner London,1,50
4669,WRPGRN,14241,14241,0,11923,2318,E09000013,E99999999,E12000007,00London,Inner London,1,50
4670,WRPIM,11312,11312,0,10821,491,E09000022,E99999999,E12000007,00London,Inner London,1,50
4671,WRSKEN,6851,6851,0,6848,3,E09000033,E99999999,E12000007,00London,Inner London,1,50
4672,WRSLO,4778,4778,0,4746,32,E09000032,E99999999,E12000007,00London,Inner London,1,50
4673,WRSTHBK,6300,6300,0,6084,216,E09000028,E99999999,E12000007,00London,Inner London,1,50
4674,WRVAUX,17619,17619,0,12990,4629,E09000028,E99999999,E12000007,00London,Inner London,1,50
4675,WRWHI,835,835,0,835,0,E09000022,E99999999,E12000007,00London,Inner London,1,50
4676,WRWKEN,9052,9052,0,8998,54,E09000013,E99999999,E12000007,00London,Inner London,1,50
4677,WRWMIN,2597,2597,0,2556,41,E09000022,E99999999,E12000007,00London,Inner London,1,50
4678,WSACH,61,42,19,23,38,S12000035,S99999999,S99999999,00QD,"Below 1,000 (b)",13,10
4679,WSAIR,20147,14250,5897,6341,13806,S12000044,S99999999,S99999999,00QZ,"Above 20,000 (a)",4,30
4680,WSALE,12108,9194,2914,3407,8701,S12000035,S99999999,S99999999,00QD,"Above 10,000 (b)",7,30
4681,WSALL,6697,5980,717,1268,5429,S12000028,S99999999,S99999999,00RE,"Above 3,000 (b)",9,10
4682,WSAMI,3161,2691,470,1388,1773,S12000006,S99999999,S99999999,00QH,"Above 3,000 (a)",8,30
4683,WSANK,1749,1476,273,1058,691,S12000008,S99999999,S99999999,00QK,"Above 1,000 (b)",11,10
4684,WSANN,4838,4641,197,2630,2208,E07000026,E10000006,E12000002,16,"Above 3,000 (b)",9,10
4685,WSAPP,301,98,203,16,285,S12000035,S99999999,S99999999,00QD,"Below 1,000 (b)",13,10
4686,WSARD,15920,10938,4982,4373,11547,S12000021,S99999999,S99999999,00QY,"Above 10,000 (b)",7,30
4687,WSARL,170,60,110,33,137,S12000006,S99999999,S99999999,00QH,"Below 1,000 (a)",12,10
4688,WSARN,170,103,67,55,115,S12000035,S99999999,S99999999,00QD,"Below 1,000 (b)",13,10
4689,WSARO,271,155,116,138,133,S12000035,S99999999,S99999999,00QD,"Below 1,000 (b)",13,10
4690,WSARR,417,296,121,217,200,S12000035,S99999999,S99999999,00QD,"Below 1,000 (a)",12,10
4691,WSARY,193,87,106,87,106,S12000035,S99999999,S99999999,00QD,"Below 1,000 (b)",13,10
4692,WSAUC,253,170,83,138,115,S12000006,S99999999,S99999999,00QH,"Below 1,000 (b)",13,10
4693,WSAUG,103,35,68,16,87,S12000006,S99999999,S99999999,00QH,"Below 1,000 (b)",13,10
4694,WSAUL,533,236,297,67,466,S12000006,S99999999,S99999999,00QH,"Below 1,000 (b)",13,10
4695,WSAYR,16943,12496,4447,5993,10950,S12000028,S99999999,S99999999,00RE,"Above 10,000 (b)",7,30
4696,WSBAA,110,34,76,27,83,S12000030,S99999999,S99999999,00RG,"Below 1,000 (b)",13,10
4697,WSBAB,338,36,302,22,316,S12000035,S99999999,S99999999,00QD,"Below 1,000 (b)",13,10
4698,WSBAE,387,277,110,248,139,S12000006,S99999999,S99999999,00QH,"Below 1,000 (b)",13,10
4699,WSBAG,134,62,72,10,124,S12000006,S99999999,S99999999,00QH,"Below 1,000 (b)",13,10
4700,WSBAH,180,120,60,87,93,S12000028,S99999999,S99999999,00RE,"Below 1,000 (a)",12,10
4701,WSBAI,15381,12600,2781,5857,9524,S12000029,S99999999,S99999999,00RF,"Above 10,000 (b)",7,30
4702,WSBAL,1098,970,128,908,190,S12000030,S99999999,S99999999,00RG,"Above 1,000 (b)",11,10
4703,WSBAM,1312,1238,74,945,367,S12000045,S99999999,S99999999,00QL,"Above 1,000 (b)",11,10
4704,WSBAN,130,43,87,18,112,S12000006,S99999999,S99999999,00QH,"Below 1,000 (b)",13,10
4705,WSBAV,425,193,232,79,346,S12000035,S99999999,S99999999,00QD,"Below 1,000 (a)",12,10
4706,WSBDD,315,204,111,158,157,S12000006,S99999999,S99999999,00QH,"Below 1,000 (b)",13,10
4707,WSBEA,12469,11362,1107,3600,8869,S12000045,S99999999,S99999999,00QL,Large City,2,50
4708,WSBEH,11416,10745,671,5081,6335,S12000044,S99999999,S99999999,00QZ,"Above 10,000 (b)",7,30
4709,WSBEI,3356,3071,285,2701,655,S12000038,S99999999,S99999999,00RC,"Above 3,000 (b)",9,10
4710,WSBEL,6501,6501,0,4867,1634,S12000046,S99999999,S99999999,00QS,"Above 3,000 (a)",8,30
4711,WSBEN,139,37,102,18,121,S12000006,S99999999,S99999999,00QH,"Below 1,000 (b)",13,10
4712,WSBET,387,285,102,208,179,S12000006,S99999999,S99999999,00QH,"Below 1,000 (b)",13,10
4713,WSBIG,1587,1436,151,1292,295,S12000026,S99999999,S99999999,00QE,"Above 1,000 (b)",11,10
4714,WSBIN,3096,2588,508,2265,831,S12000038,S99999999,S99999999,00RC,"Above 3,000 (b)",9,10
4715,WSBIS,14215,12874,1341,5040,9175,S12000044,S99999999,S99999999,00QZ,"Above 10,000 (b)",7,30
4716,WSBLA,16141,12979,3162,3552,12589,S12000029,S99999999,S99999999,00RF,"Above 10,000 (a)",6,30
4717,WSBLN,1052,899,153,728,324,S12000030,S99999999,S99999999,00RG,"Above 1,000 (b)",11,10
4718,WSBOE,250,100,150,57,193,S12000006,S99999999,S99999999,00QH,"Below 1,000 (b)",13,10
4719,WSBON,69,14,55,3,66,S12000035,S99999999,S99999999,00QD,"Below 1,000 (b)",13,10
4720,WSBOR,195,65,130,40,155,S12000006,S99999999,S99999999,00QH,"Below 1,000 (b)",13,10
4721,WSBOT,3510,3369,141,2896,614,S12000029,S99999999,S99999999,00RF,"Above 3,000 (b)",9,10
4722,WSBOW,651,480,171,443,208,S12000035,S99999999,S99999999,00QD,"Below 1,000 (b)",13,10
4723,WSBRD,765,680,85,545,220,S12000021,S99999999,S99999999,00QY,"Below 1,000 (a)",12,10
4724,WSBRE,10095,9897,198,4565,5530,S12000038,S99999999,S99999999,00RC,"Above 10,000 (b)",7,30
4725,WSBRI,14626,14626,0,8199,6427,S12000046,S99999999,S99999999,00QS,Large City,2,50
4726,WSBRO,218,177,41,146,72,S12000026,S99999999,S99999999,00QE,"Below 1,000 (a)",12,10
4727,WSBRR,13656,8619,5037,4094,9562,S12000046,S99999999,S99999999,00QS,Large City,2,50
4728,WSBRW,4404,2828,1576,1874,2530,S12000038,S99999999,S99999999,00RC,"Above 3,000 (b)",9,10
4729,WSBUC,439,337,102,271,168,S12000030,S99999999,S99999999,00RG,"Below 1,000 (b)",13,10
4730,WSBUS,6858,5991,867,4043,2815,S12000029,S99999999,S99999999,00RF,"Above 3,000 (b)",9,10
4731,WSCAA,191,56,135,48,143,S12000006,S99999999,S99999999,00QH,"Below 1,000 (b)",13,10
4732,WSCAB,7528,5769,1759,2682,4846,S12000029,S99999999,S99999999,00RF,"Above 3,000 (b)",9,10
4733,WSCAD,367,279,88,76,291,S12000035,S99999999,S99999999,00QD,"Below 1,000 (b)",13,10
4734,WSCAE,524,288,236,224,300,E07000028,E10000006,E12000002,16,"Below 1,000 (b)",13,10
4735,WSCAH,1043,807,236,713,330,S12000029,S99999999,S99999999,00RF,"Above 1,000 (b)",11,10
4736,WSCAI,112,45,67,14,98,S12000035,S99999999,S99999999,00QD,"Below 1,000 (a)",12,10
4737,WSCAL,2187,1140,1047,1053,1134,S12000044,S99999999,S99999999,00QZ,"Above 1,000 (b)",11,10
4738,WSCAM,16148,13472,2676,3808,12340,S12000029,S99999999,S99999999,00RF,"Above 10,000 (b)",7,30
4739,WSCAN,109,51,58,34,75,S12000006,S99999999,S99999999,00QH,"Below 1,000 (b)",13,10
4740,WSCAO,219,120,99,93,126,S12000006,S99999999,S99999999,00QH,"Below 1,000 (a)",12,10
4741,WSCAP,3263,2949,314,2688,575,S12000035,S99999999,S99999999,00QD,"Above 3,000 (a)",8,30
4742,WSCAR,7604,6451,1153,4289,3315,S12000029,S99999999,S99999999,00RF,"Above 3,000 (a)",8,30
4743,WSCAS,2497,2360,137,2140,357,S12000006,S99999999,S99999999,00QH,"Above 1,000 (a)",10,10
4744,WSCAT,1296,923,373,302,994,S12000029,S99999999,S99999999,00RF,"Above 1,000 (b)",11,10
4745,WSCEN,9118,9118,0,5601,3517,S12000046,S99999999,S99999999,00QS,"Above 3,000 (a)",8,30
4746,WSCHA,168,32,136,8,160,E07000028,E10000006,E12000002,16,"Below 1,000 (b)",13,10
4747,WSCHN,522,347,175,310,212,S12000029,S99999999,S99999999,00RF,"Below 1,000 (b)",13,10
4748,WSCLA,141,56,85,24,117,S12000035,S99999999,S99999999,00QD,"Below 1,000 (b)",13,10
4749,WSCLD,282,161,121,110,172,S12000006,S99999999,S99999999,00QH,"Below 1,000 (a)",12,10
4750,WSCLE,3802,2982,820,1374,2428,S12000044,S99999999,S99999999,00QZ,"Above 3,000 (b)",9,10
4751,WSCLR,704,597,107,456,248,S12000035,S99999999,S99999999,00QD,"Below 1,000 (b)",13,10
4752,WSCLY,7729,7698,31,3106,4623,S12000038,S99999999,S99999999,00RC,"Above 3,000 (b)",9,10
4753,WSCMM,302,230,72,149,153,S12000006,S99999999,S99999999,00QH,"Below 1,000 (b)",13,10
4754,WSCMN,7059,4348,2711,2366,4693,S12000008,S99999999,S99999999,00QK,"Above 3,000 (a)",8,30
4755,WSCOA,18204,14238,3966,5113,13091,S12000044,S99999999,S99999999,00QZ,"Above 10,000 (b)",7,30
4756,WSCOB,739,650,89,572,167,S12000029,S99999999,S99999999,00RF,"Below 1,000 (a)",12,10
4757,WSCOE,954,480,474,318,636,S12000035,S99999999,S99999999,00QD,"Below 1,000 (b)",13,10
4758,WSCOL,153,75,78,75,78,S12000035,S99999999,S99999999,00QD,"Below 1,000 (a)",12,10
4759,WSCOM,140,102,38,98,42,S12000028,S99999999,S99999999,00RE,"Below 1,000 (b)",13,10
4760,WSCON,658,352,306,264,394,S12000006,S99999999,S99999999,00QH,"Below 1,000 (b)",13,10
4761,WSCOR,176,87,89,0,176,S12000021,S99999999,S99999999,00QY,"Below 1,000 (b)",13,10
4762,WSCOS,157,65,92,46,111,S12000006,S99999999,S99999999,00QH,"Below 1,000 (b)",13,10
4763,WSCOU,160,104,56,16,144,S12000035,S99999999,S99999999,00QD,"Below 1,000 (b)",13,10
4764,WSCOV,118,75,43,0,118,S12000035,S99999999,S99999999,00QD,"Below 1,000 (b)",13,10
4765,WSCOY,155,20,135,6,149,S12000035,S99999999,S99999999,00QD,"Below 1,000 (b)",13,10
4766,WSCRA,10758,10430,328,4985,5773,S12000046,S99999999,S99999999,00QS,Large City,2,50
4767,WSCRC,212,122,90,94,118,S12000006,S99999999,S99999999,00QH,"Below 1,000 (a)",12,10
4768,WSCRE,567,405,162,398,169,S12000006,S99999999,S99999999,00QH,"Below 1,000 (b)",13,10
4769,WSCRG,1927,131,1796,34,1893,S12000008,S99999999,S99999999,00QK,"Above 1,000 (b)",11,10
4770,WSCRH,331,277,54,247,84,S12000028,S99999999,S99999999,00RE,"Below 1,000 (b)",13,10
4771,WSCRI,155,69,86,63,92,S12000030,S99999999,S99999999,00RG,"Below 1,000 (b)",13,10
4772,WSCRJ,91,40,51,32,59,S12000029,S99999999,S99999999,00RF,"Below 1,000 (b)",13,10
4773,WSCRL,349,290,59,223,126,S12000006,S99999999,S99999999,00QH,"Below 1,000 (b)",13,10
4774,WSCRN,187,69,118,62,125,S12000035,S99999999,S99999999,00QD,"Below 1,000 (b)",13,10
4775,WSCRO,15224,14865,359,7138,8086,S12000029,S99999999,S99999999,00RF,"Above 10,000 (a)",6,30
4776,WSCRS,1850,550,1300,369,1481,S12000029,S99999999,S99999999,00RF,"Above 1,000 (b)",11,10
4777,WSCRU,184,67,117,0,184,S12000035,S99999999,S99999999,00QD,"Below 1,000 (b)",13,10
4778,WSCRW,387,185,202,63,324,S12000029,S99999999,S99999999,00RF,"Below 1,000 (b)",13,10
4779,WSCSS,1143,1061,82,952,191,S12000035,S99999999,S99999999,00QD,"Above 1,000 (a)",10,10
4780,WSCUM,21026,11102,9924,4149,16877,S12000044,S99999999,S99999999,00QZ,"Above 20,000 (b)",5,30
4781,WSDAE,1134,807,327,731,403,S12000008,S99999999,S99999999,00QK,"Above 1,000 (b)",11,10
4782,WSDAK,418,291,127,265,153,S12000006,S99999999,S99999999,00QH,"Below 1,000 (a)",12,10
4783,WSDAL,2416,2345,71,2226,190,S12000006,S99999999,S99999999,00QH,"Above 1,000 (a)",10,10
4784,WSDAM,1524,1445,79,876,648,S12000008,S99999999,S99999999,00QK,"Above 1,000 (a)",10,10
4785,WSDAR,3042,2874,168,2328,714,S12000021,S99999999,S99999999,00QY,"Above 3,000 (b)",9,10
4786,WSDAS,80,35,45,3,77,S12000008,S99999999,S99999999,00QK,"Below 1,000 (b)",13,10
4787,WSDAV,2925,2053,872,1882,1043,S12000008,S99999999,S99999999,00QK,"Above 1,000 (b)",11,10
4788,WSDAY,298,182,116,6,292,S12000035,S99999999,S99999999,00QD,"Below 1,000 (b)",13,10
4789,WSDER,260,71,189,9,251,S12000035,S99999999,S99999999,00QD,"Below 1,000 (b)",13,10
4790,WSDMS,14897,12418,2479,5370,9527,S12000006,S99999999,S99999999,00QH,"Above 10,000 (a)",6,30
4791,WSDOL,950,830,120,807,143,S12000029,S99999999,S99999999,00RF,"Below 1,000 (a)",12,10
4792,WSDOU,5872,5872,0,4450,1422,S12000046,S99999999,S99999999,00QS,"Above 3,000 (a)",8,30
4793,WSDOW,625,473,152,60,565,S12000029,S99999999,S99999999,00RF,"Below 1,000 (b)",13,10
4794,WSDRE,352,255,97,201,151,S12000006,S99999999,S99999999,00QH,"Below 1,000 (b)",13,10
4795,WSDRG,264,93,171,43,221,S12000029,S99999999,S99999999,00RF,"Below 1,000 (b)",13,10
4796,WSDRN,728,587,141,419,309,S12000030,S99999999,S99999999,00RG,"Below 1,000 (b)",13,10
4797,WSDRO,1910,1591,319,1494,416,S12000008,S99999999,S99999999,00QK,"Above 1,000 (b)",11,10
4798,WSDRU,11281,11244,37,4709,6572,S12000045,S99999999,S99999999,00QL,Large City,2,50
4799,WSDRY,1740,1286,454,965,775,S12000008,S99999999,S99999999,00QK,"Above 1,000 (b)",11,10
4800,WSDUE,95,35,60,7,88,S12000006,S99999999,S99999999,00QH,"Below 1,000 (b)",13,10
4801,WSDUI,248,160,88,115,133,S12000006,S99999999,S99999999,00QH,"Below 1,000 (b)",13,10
4802,WSDUM,11185,9536,1649,4378,6807,S12000039,S99999999,S99999999,00QG,"Above 10,000 (a)",6,30
4803,WSDUN,4707,4465,242,3186,1521,S12000035,S99999999,S99999999,00QD,"Above 3,000 (a)",8,30
4804,WSDUO,205,92,113,0,205,S12000017,S99999999,S99999999,00QT,"Below 1,000 (b)",13,10
4805,WSDUR,135,90,45,6,129,S12000006,S99999999,S99999999,00QH,"Below 1,000 (b)",13,10
4806,WSDUS,406,155,251,99,307,S12000006,S99999999,S99999999,00QH,"Below 1,000 (b)",13,10
4807,WSDUT,9127,8569,558,4826,4301,S12000045,S99999999,S99999999,00QL,"Above 3,000 (b)",9,10
4808,WSDUU,356,255,101,67,289,S12000028,S99999999,S99999999,00RE,"Below 1,000 (b)",13,10
4809,WSDUY,199,44,155,18,181,S12000029,S99999999,S99999999,00RF,"Below 1,000 (b)",13,10
4810,WSEAG,3766,1856,1910,1525,2241,S12000029,S99999999,S99999999,00RF,"Above 3,000 (b)",9,10
4811,WSEAS,1211,984,227,895,316,E07000026,E10000006,E12000002,16,"Above 1,000 (b)",11,10
4812,WSECC,760,510,250,460,300,S12000006,S99999999,S99999999,00QH,"Below 1,000 (b)",13,10
4813,WSEKI,33784,20941,12843,5772,28012,S12000029,S99999999,S99999999,00RF,"Above 20,000 (b)",5,30
4814,WSELV,49,0,49,0,49,S12000006,S99999999,S99999999,00QH,"Below 1,000 (b)",13,10
4815,WSERS,9344,7502,1842,3529,5815,S12000038,S99999999,S99999999,00RC,"Above 3,000 (b)",9,10
4816,WSESK,179,21,158,21,158,S12000006,S99999999,S99999999,00QH,"Below 1,000 (b)",13,10
4817,WSFAI,825,810,15,541,284,S12000021,S99999999,S99999999,00QY,"Below 1,000 (b)",13,10
4818,WSFEN,810,586,224,491,319,S12000008,S99999999,S99999999,00QK,"Below 1,000 (b)",13,10
4819,WSFIN,330,241,89,174,156,S12000030,S99999999,S99999999,00RG,"Below 1,000 (b)",13,10
4820,WSFIO,448,24,424,18,430,S12000035,S99999999,S99999999,00QD,"Below 1,000 (b)",13,10
4821,WSFIV,1018,97,921,11,1007,S12000008,S99999999,S99999999,00QK,"Above 1,000 (b)",11,10
4822,WSFOR,2940,656,2284,112,2828,S12000019,S99999999,S99999999,00QW,"Above 1,000 (b)",11,10
4823,WSFOT,1419,1151,268,86,1333,S12000029,S99999999,S99999999,00RF,"Above 1,000 (b)",11,10
4824,WSFUR,226,91,135,53,173,S12000035,S99999999,S99999999,00QD,"Below 1,000 (b)",13,10
4825,WSGAE,804,718,86,622,182,S12000035,S99999999,S99999999,00QD,"Below 1,000 (b)",13,10
4826,WSGAI,263,239,24,209,54,S12000006,S99999999,S99999999,00QH,"Below 1,000 (a)",12,10
4827,WSGAL,3383,2498,885,2093,1290,S12000008,S99999999,S99999999,00QK,"Above 3,000 (b)",9,10
4828,WSGAR,330,185,145,132,198,S12000030,S99999999,S99999999,00RG,"Below 1,000 (b)",13,10
4829,WSGAT,824,687,137,538,286,S12000006,S99999999,S99999999,00QH,"Below 1,000 (b)",13,10
4830,WSGIF,14474,8736,5738,3527,10947,S12000046,S99999999,S99999999,00QS,Large City,2,50
4831,WSGIG,112,66,46,8,104,S12000035,S99999999,S99999999,00QD,"Below 1,000 (b)",13,10
4832,WSGIR,3744,3623,121,2970,774,S12000028,S99999999,S99999999,00RE,"Above 3,000 (a)",8,30
4833,WSGLC,338,179,159,135,203,S12000006,S99999999,S99999999,00QH,"Below 1,000 (b)",13,10
4834,WSGLE,158,49,109,49,109,S12000035,S99999999,S99999999,00QD,"Below 1,000 (b)",13,10
4835,WSGLG,6976,1906,5070,1105,5871,S12000044,S99999999,S99999999,00QZ,"Above 3,000 (b)",9,10
4836,WSGLL,129,12,117,12,117,S12000035,S99999999,S99999999,00QD,"Below 1,000 (b)",13,10
4837,WSGLU,451,382,69,349,102,S12000006,S99999999,S99999999,00QH,"Below 1,000 (b)",13,10
4838,WSGOU,10751,7587,3164,3384,7367,S12000018,S99999999,S99999999,00QU,"Above 10,000 (b)",7,30
4839,WSGOV,11950,11946,4,5823,6127,S12000046,S99999999,S99999999,00QS,Large City,2,50
4840,WSGRE,14827,13233,1594,6654,8173,S12000018,S99999999,S99999999,00QU,"Above 10,000 (a)",6,30
4841,WSGRS,1032,556,476,356,676,S12000044,S99999999,S99999999,00QZ,"Above 1,000 (b)",11,10
4842,WSGRT,2027,1894,133,1600,427,E07000028,E10000006,E12000002,16,"Above 1,000 (b)",11,10
4843,WSHAL,24456,18405,6051,7740,16716,S12000046,S99999999,S99999999,00QS,Large City,2,50
4844,WSHAM,18765,13180,5585,5574,13191,S12000029,S99999999,S99999999,00RF,"Above 10,000 (a)",6,30
4845,WSHAU,280,203,77,172,108,S12000006,S99999999,S99999999,00QH,"Below 1,000 (b)",13,10
4846,WSHEL,7257,5746,1511,3079,4178,S12000035,S99999999,S99999999,00QD,"Above 3,000 (b)",9,10
4847,WSHOL,11270,7538,3732,3304,7966,S12000044,S99999999,S99999999,00QZ,"Above 10,000 (a)",6,30
4848,WSIBR,7237,7163,74,5169,2068,S12000046,S99999999,S99999999,00QS,"Above 3,000 (a)",8,30
4849,WSINN,647,562,85,361,286,S12000035,S99999999,S99999999,00QD,"Below 1,000 (b)",13,10
4850,WSINS,24,9,15,9,15,S12000035,S99999999,S99999999,00QD,"Below 1,000 (b)",13,10
4851,WSINV,417,344,73,284,133,S12000035,S99999999,S99999999,00QD,"Below 1,000 (b)",13,10
4852,WSIRS,9361,8261,1100,3284,6077,S12000021,S99999999,S99999999,00QY,"Above 3,000 (a)",8,30
4853,WSIRV,9693,9277,416,4517,5176,S12000021,S99999999,S99999999,00QY,"Above 3,000 (b)",9,10
4854,WSJOB,353,104,249,73,280,S12000006,S99999999,S99999999,00QH,"Below 1,000 (b)",13,10
4855,WSJOH,13170,12093,1077,5025,8145,S12000038,S99999999,S99999999,00RC,Large City,2,50
4856,WSJOP,1533,1390,143,1019,514,S12000008,S99999999,S99999999,00QK,"Above 1,000 (b)",11,10
4857,WSJUR,153,80,73,33,120,S12000035,S99999999,S99999999,00QD,"Below 1,000 (b)",13,10
4858,WSKBN,4797,3338,1459,1687,3110,S12000038,S99999999,S99999999,00RC,"Above 3,000 (b)",9,10
4859,WSKET,188,86,102,23,165,S12000006,S99999999,S99999999,00QH,"Below 1,000 (b)",13,10
4860,WSKGE,489,339,150,165,324,S12000006,S99999999,S99999999,00QH,"Below 1,000 (b)",13,10
4861,WSKIA,951,828,123,717,234,S12000030,S99999999,S99999999,00RG,"Below 1,000 (b)",13,10
4862,WSKIB,243,158,85,41,202,S12000035,S99999999,S99999999,00QD,"Below 1,000 (b)",13,10
4863,WSKIC,171,24,147,0,171,S12000035,S99999999,S99999999,00QD,"Below 1,000 (b)",13,10
4864,WSKID,163,105,58,64,99,S12000021,S99999999,S99999999,00QY,"Below 1,000 (b)",13,10
4865,WSKIE,4021,3405,616,1800,2221,S12000021,S99999999,S99999999,00QY,"Above 3,000 (a)",8,30
4866,WSKIF,88,23,65,23,65,S12000035,S99999999,S99999999,00QD,"Below 1,000 (b)",13,10
4867,WSKIG,661,609,52,406,255,S12000035,S99999999,S99999999,00QD,"Below 1,000 (a)",12,10
4868,WSKII,46,18,28,4,42,S12000035,S99999999,S99999999,00QD,"Below 1,000 (b)",13,10
4869,WSKIK,253,58,195,50,203,S12000035,S99999999,S99999999,00QD,"Below 1,000 (b)",13,10
4870,WSKIL,25415,15134,10281,5338,20077,S12000008,S99999999,S99999999,00QK,"Above 20,000 (a)",4,30
4871,WSKIM,2155,1995,160,1791,364,S12000038,S99999999,S99999999,00RC,"Above 1,000 (b)",11,10
4872,WSKIN,52,29,23,29,23,S12000035,S99999999,S99999999,00QD,"Below 1,000 (a)",12,10
4873,WSKIO,164,58,106,39,125,S12000035,S99999999,S99999999,00QD,"Below 1,000 (b)",13,10
4874,WSKIP,326,283,43,197,129,S12000006,S99999999,S99999999,00QH,"Below 1,000 (a)",12,10
4875,WSKIR,14574,11737,2837,5020,9554,S12000044,S99999999,S99999999,00QZ,"Above 10,000 (b)",7,30
4876,WSKIU,1522,826,696,223,1299,S12000035,S99999999,S99999999,00QD,"Above 1,000 (b)",11,10
4877,WSKIW,8671,7730,941,4455,4216,S12000021,S99999999,S99999999,00QY,"Above 3,000 (b)",9,10
4878,WSKIY,8273,5415,2858,3813,4460,S12000044,S99999999,S99999999,00QZ,"Above 3,000 (b)",9,10
4879,WSKKC,291,167,124,139,152,S12000006,S99999999,S99999999,00QH,"Below 1,000 (a)",12,10
4880,WSKKD,442,282,160,121,321,S12000006,S99999999,S99999999,00QH,"Below 1,000 (b)",13,10
4881,WSKKE,277,239,38,201,76,S12000028,S99999999,S99999999,00RE,"Below 1,000 (b)",13,10
4882,WSKKF,372,297,75,115,257,S12000006,S99999999,S99999999,00QH,"Below 1,000 (b)",13,10
4883,WSKKL,1109,1055,54,998,111,S12000006,S99999999,S99999999,00QH,"Above 1,000 (b)",11,10
4884,WSKKN,368,257,111,218,150,S12000006,S99999999,S99999999,00QH,"Below 1,000 (a)",12,10
4885,WSKKO,365,177,188,144,221,S12000028,S99999999,S99999999,00RE,"Below 1,000 (b)",13,10
4886,WSKKR,259,159,100,128,131,S12000006,S99999999,S99999999,00QH,"Below 1,000 (a)",12,10
4887,WSKKT,2118,2000,118,1601,517,S12000006,S99999999,S99999999,00QH,"Above 1,000 (a)",10,10
4888,WSKKZ,226,90,136,22,204,S12000006,S99999999,S99999999,00QH,"Below 1,000 (b)",13,10
4889,WSKLM,165,74,91,52,113,S12000035,S99999999,S99999999,00QD,"Below 1,000 (b)",13,10
4890,WSKLN,251,89,162,35,216,S12000035,S99999999,S99999999,00QD,"Below 1,000 (b)",13,10
4891,WSKRK,275,42,233,20,255,S12000006,S99999999,S99999999,00QH,"Below 1,000 (b)",13,10
4892,WSLAA,8445,7159,1286,3811,4634,S12000029,S99999999,S99999999,00RF,"Above 3,000 (b)",9,10
4893,WSLAB,587,510,77,393,194,S12000038,S99999999,S99999999,00RC,"Below 1,000 (a)",12,10
4894,WSLAH,1366,1258,108,1168,198,S12000006,S99999999,S99999999,00QH,"Above 1,000 (a)",10,10
4895,WSLAK,5975,5172,803,3012,2963,S12000029,S99999999,S99999999,00RF,"Above 3,000 (b)",9,10
4896,WSLAL,841,784,57,566,275,S12000021,S99999999,S99999999,00QY,"Below 1,000 (b)",13,10
4897,WSLAM,240,76,164,12,228,S12000029,S99999999,S99999999,00RF,"Below 1,000 (b)",13,10
4898,WSLAN,17804,17528,276,10718,7086,S12000046,S99999999,S99999999,00QS,Large City,2,50
4899,WSLAR,6614,6502,112,4982,1632,S12000021,S99999999,S99999999,00QY,"Above 3,000 (b)",9,10
4900,WSLAU,118,86,32,73,45,S12000006,S99999999,S99999999,00QH,"Below 1,000 (b)",13,10
4901,WSLEA,319,182,137,145,174,S12000006,S99999999,S99999999,00QH,"Below 1,000 (b)",13,10
4902,WSLED,455,168,287,26,429,S12000035,S99999999,S99999999,00QD,"Below 1,000 (b)",13,10
4903,WSLEN,90,57,33,33,57,S12000028,S99999999,S99999999,00RE,"Below 1,000 (b)",13,10
4904,WSLES,3973,2232,1741,1254,2719,S12000029,S99999999,S99999999,00RF,"Above 3,000 (a)",8,30
4905,WSLEW,341,138,203,21,320,S12000006,S99999999,S99999999,00QH,"Below 1,000 (b)",13,10
4906,WSLEX,3343,2036,1307,1725,1618,S12000045,S99999999,S99999999,00QL,"Above 3,000 (b)",9,10
4907,WSLID,584,472,112,442,142,E07000028,E10000006,E12000002,16,"Below 1,000 (b)",13,10
4908,WSLIS,130,49,81,49,81,S12000035,S99999999,S99999999,00QD,"Below 1,000 (b)",13,10
4909,WSLOA,181,120,61,76,105,S12000021,S99999999,S99999999,00QY,"Below 1,000 (b)",13,10
4910,WSLOC,2602,1534,1068,1251,1351,S12000035,S99999999,S99999999,00QD,"Above 1,000 (b)",11,10
4911,WSLOD,343,139,204,5,338,S12000035,S99999999,S99999999,00QD,"Below 1,000 (b)",13,10
4912,WSLOE,2470,2354,116,1828,642,S12000006,S99999999,S99999999,00QH,"Above 1,000 (b)",11,10
4913,WSLOG,178,61,117,12,166,S12000008,S99999999,S99999999,00QK,"Below 1,000 (b)",13,10
4914,WSLOH,305,0,305,0,305,S12000035,S99999999,S99999999,00QD,"Below 1,000 (b)",13,10
4915,WSLOI,1608,1438,170,1296,312,S12000038,S99999999,S99999999,00RC,"Above 1,000 (b)",11,10
4916,WSLON,1581,1133,448,1058,523,S12000006,S99999999,S99999999,00QH,"Above 1,000 (b)",11,10
4917,WSLOS,320,198,122,154,166,S12000006,S99999999,S99999999,00QH,"Below 1,000 (b)",13,10
4918,WSLOT,421,155,266,99,322,S12000006,S99999999,S99999999,00QH,"Below 1,000 (a)",12,10
4919,WSLUI,157,71,86,59,98,S12000035,S99999999,S99999999,00QD,"Below 1,000 (b)",13,10
4920,WSLUS,142,91,51,80,62,S12000030,S99999999,S99999999,00RG,"Below 1,000 (b)",13,10
4921,WSMAB,112,12,100,8,104,S12000006,S99999999,S99999999,00QH,"Below 1,000 (b)",13,10
4922,WSMAC,46,23,23,15,31,S12000021,S99999999,S99999999,00QY,"Below 1,000 (b)",13,10
4923,WSMAH,202,78,124,78,124,S12000035,S99999999,S99999999,00QD,"Below 1,000 (b)",13,10
4924,WSMAR,19778,18001,1777,9631,10147,S12000046,S99999999,S99999999,00QS,Large City,2,50
4925,WSMAU,3564,2037,1527,1744,1820,S12000008,S99999999,S99999999,00QK,"Above 3,000 (b)",9,10
4926,WSMAY,2491,2394,97,2302,189,S12000028,S99999999,S99999999,00RE,"Above 1,000 (a)",10,10
4927,WSMER,10972,10488,484,5620,5352,S12000046,S99999999,S99999999,00QS,Large City,2,50
4928,WSMIL,7533,6958,575,4067,3466,S12000030,S99999999,S99999999,00RG,"Above 3,000 (b)",9,10
4929,WSMIN,205,80,125,80,125,S12000035,S99999999,S99999999,00QD,"Below 1,000 (b)",13,10
4930,WSMIT,1419,1357,62,1036,383,S12000021,S99999999,S99999999,00QY,"Above 1,000 (b)",11,10
4931,WSMOC,103,12,91,7,96,S12000006,S99999999,S99999999,00QH,"Below 1,000 (b)",13,10
4932,WSMOD,151,30,121,8,143,S12000006,S99999999,S99999999,00QH,"Below 1,000 (b)",13,10
4933,WSMOF,1648,1544,104,1389,259,S12000006,S99999999,S99999999,00QH,"Above 1,000 (a)",10,10
4934,WSMON,529,302,227,258,271,S12000006,S99999999,S99999999,00QH,"Below 1,000 (b)",13,10
4935,WSMOS,201,113,88,69,132,S12000008,S99999999,S99999999,00QK,"Below 1,000 (b)",13,10
4936,WSMOT,13710,12215,1495,5223,8487,S12000029,S99999999,S99999999,00RF,"Above 10,000 (b)",7,30
4937,WSMOU,188,99,89,38,150,S12000006,S99999999,S99999999,00QH,"Below 1,000 (b)",13,10
4938,WSMUI,878,800,78,446,432,S12000008,S99999999,S99999999,00QK,"Below 1,000 (a)",12,10
4939,WSNEA,322,249,73,211,111,S12000006,S99999999,S99999999,00QH,"Below 1,000 (a)",12,10
4940,WSNEB,3395,2990,405,500,2895,S12000006,S99999999,S99999999,00QH,"Above 3,000 (b)",9,10
4941,WSNEC,1628,1506,122,1252,376,S12000006,S99999999,S99999999,00QH,"Above 1,000 (b)",11,10
4942,WSNEG,425,280,145,217,208,S12000006,S99999999,S99999999,00QH,"Below 1,000 (b)",13,10
4943,WSNEL,115,58,57,52,63,S12000006,S99999999,S99999999,00QH,"Below 1,000 (b)",13,10
4944,WSNES,2477,2217,260,1773,704,S12000006,S99999999,S99999999,00QH,"Above 1,000 (b)",11,10
4945,WSNEW,10705,10163,542,3432,7273,S12000046,S99999999,S99999999,00QS,Large City,2,50
4946,WSOBA,4939,4659,280,2671,2268,S12000035,S99999999,S99999999,00QD,"Above 3,000 (a)",8,30
4947,WSOCH,670,553,117,519,151,S12000008,S99999999,S99999999,00QK,"Below 1,000 (a)",12,10
4948,WSOLD,701,451,250,417,284,S12000028,S99999999,S99999999,00RE,"Below 1,000 (b)",13,10
4949,WSORM,139,0,139,0,139,S12000035,S99999999,S99999999,00QD,"Below 1,000 (b)",13,10
4950,WSPAI,20159,19282,877,9367,10792,S12000038,S99999999,S99999999,00RC,Large City,2,50
4951,WSPAL,162,134,28,113,49,S12000006,S99999999,S99999999,00QH,"Below 1,000 (b)",13,10
4952,WSPAN,144,47,97,27,117,S12000006,S99999999,S99999999,00QH,"Below 1,000 (b)",13,10
4953,WSPAR,397,118,279,48,349,S12000006,S99999999,S99999999,00QH,"Below 1,000 (b)",13,10
4954,WSPAT,1166,1005,161,700,466,S12000008,S99999999,S99999999,00QK,"Above 1,000 (b)",11,10
4955,WSPEN,57,0,57,0,57,S12000035,S99999999,S99999999,00QD,"Below 1,000 (b)",13,10
4956,WSPIN,148,49,99,22,126,S12000028,S99999999,S99999999,00RE,"Below 1,000 (b)",13,10
4957,WSPIR,94,8,86,8,86,S12000021,S99999999,S99999999,00QY,"Below 1,000 (a)",12,10
4958,WSPOA,195,76,119,27,168,S12000035,S99999999,S99999999,00QD,"Below 1,000 (b)",13,10
4959,WSPOC,383,92,291,24,359,S12000035,S99999999,S99999999,00QD,"Below 1,000 (b)",13,10
4960,WSPOE,656,476,180,457,199,S12000035,S99999999,S99999999,00QD,"Below 1,000 (a)",12,10
4961,WSPOL,14305,14305,0,12440,1865,S12000046,S99999999,S99999999,00QS,Large City,2,50
4962,WSPOP,582,454,128,76,506,S12000006,S99999999,S99999999,00QH,"Below 1,000 (b)",13,10
4963,WSPOR,175,136,39,123,52,S12000035,S99999999,S99999999,00QD,"Below 1,000 (a)",12,10
4964,WSPOS,6455,6435,20,3650,2805,S12000046,S99999999,S99999999,00QS,"Above 3,000 (b)",9,10
4965,WSPOW,604,329,275,306,298,S12000006,S99999999,S99999999,00QH,"Below 1,000 (b)",13,10
4966,WSPRE,9191,7654,1537,4373,4818,S12000028,S99999999,S99999999,00RE,"Above 3,000 (b)",9,10
4967,WSPRO,11916,11584,332,5614,6302,S12000046,S99999999,S99999999,00QS,Large City,2,50
4968,WSPTH,4928,4883,45,3788,1140,S12000018,S99999999,S99999999,00QU,"Above 3,000 (b)",9,10
4969,WSPTN,3702,3228,474,2378,1324,S12000018,S99999999,S99999999,00QU,"Above 3,000 (b)",9,10
4970,WSREN,14212,13356,856,5578,8634,S12000046,S99999999,S99999999,00QS,Large City,2,50
4971,WSRHU,937,794,143,697,240,S12000035,S99999999,S99999999,00QD,"Below 1,000 (b)",13,10
4972,WSRIN,186,128,58,55,131,S12000006,S99999999,S99999999,00QH,"Below 1,000 (b)",13,10
4973,WSROC,358,227,131,128,230,S12000006,S99999999,S99999999,00QH,"Below 1,000 (b)",13,10
4974,WSROT,4312,3377,935,2664,1648,S12000035,S99999999,S99999999,00QD,"Above 3,000 (a)",8,30
4975,WSRUT,11634,11634,0,6594,5040,S12000029,S99999999,S99999999,00RF,"Above 10,000 (a)",6,30
4976,WSSAL,799,665,134,609,190,S12000044,S99999999,S99999999,00QZ,"Below 1,000 (b)",13,10
4977,WSSAN,443,230,213,184,259,S12000006,S99999999,S99999999,00QH,"Below 1,000 (a)",12,10
4978,WSSAQ,1144,1043,101,1015,129,S12000006,S99999999,S99999999,00QH,"Above 1,000 (b)",11,10
4979,WSSCA,534,97,437,70,464,S12000035,S99999999,S99999999,00QD,"Below 1,000 (a)",12,10
4980,WSSCO,17302,17158,144,6695,10607,S12000046,S99999999,S99999999,00QS,Large City,2,50
4981,WSSHE,15387,15094,293,8591,6796,S12000046,S99999999,S99999999,00QS,Large City,2,50
4982,WSSHI,404,279,125,97,307,S12000021,S99999999,S99999999,00QY,"Below 1,000 (b)",13,10
4983,WSSKI,61,25,36,25,36,S12000035,S99999999,S99999999,00QD,"Below 1,000 (b)",13,10
4984,WSSKL,203,93,110,69,134,S12000026,S99999999,S99999999,00QE,"Below 1,000 (a)",12,10
4985,WSSLI,134,45,89,45,89,S12000021,S99999999,S99999999,00QY,"Below 1,000 (a)",12,10
4986,WSSOE,232,126,106,94,138,S12000035,S99999999,S99999999,00QD,"Below 1,000 (b)",13,10
4987,WSSOK,216,127,89,15,201,S12000006,S99999999,S99999999,00QH,"Below 1,000 (b)",13,10
4988,WSSOR,223,113,110,83,140,S12000006,S99999999,S99999999,00QH,"Below 1,000 (b)",13,10
4989,WSSOU,4227,4227,0,3681,546,S12000046,S99999999,S99999999,00QS,"Above 3,000 (a)",8,30
4990,WSSPR,9818,9622,196,5458,4360,S12000046,S99999999,S99999999,00QS,"Above 3,000 (a)",8,30
4991,WSSTD,87,8,79,8,79,S12000026,S99999999,S99999999,00QE,"Below 1,000 (b)",13,10
4992,WSSTE,7093,4018,3075,1846,5247,S12000044,S99999999,S99999999,00QZ,"Above 3,000 (a)",8,30
4993,WSSTN,3887,3554,333,2562,1325,S12000029,S99999999,S99999999,00RF,"Above 3,000 (a)",8,30
4994,WSSTO,1877,1651,226,1392,485,S12000029,S99999999,S99999999,00RF,"Above 1,000 (b)",11,10
4995,WSSTR,5928,5459,469,3223,2705,S12000006,S99999999,S99999999,00QH,"Above 3,000 (a)",8,30
4996,WSSTT,172,116,56,96,76,S12000028,S99999999,S99999999,00RE,"Below 1,000 (b)",13,10
4997,WSSTU,461,281,180,136,325,S12000035,S99999999,S99999999,00QD,"Below 1,000 (a)",12,10
4998,WSSTW,4430,3591,839,3269,1161,S12000008,S99999999,S99999999,00QK,"Above 3,000 (b)",9,10
4999,WSSYM,808,724,84,597,211,S12000028,S99999999,S99999999,00RE,"Below 1,000 (b)",13,10
5000,WSTAB,797,705,92,607,190,S12000035,S99999999,S99999999,00QD,"Below 1,000 (a)",12,10
5001,WSTAH,258,131,127,131,127,S12000035,S99999999,S99999999,00QD,"Below 1,000 (a)",12,10
5002,WSTAR,1038,934,104,891,147,S12000008,S99999999,S99999999,00QK,"Above 1,000 (b)",11,10
5003,WSTAT,542,419,123,270,272,S12000035,S99999999,S99999999,00QD,"Below 1,000 (a)",12,10
5004,WSTAY,134,0,134,0,134,S12000035,S99999999,S99999999,00QD,"Below 1,000 (b)",13,10
5005,WSTHL,1730,1019,711,939,791,S12000006,S99999999,S99999999,00QH,"Above 1,000 (a)",10,10
5006,WSTHO,10386,10005,381,6066,4320,S12000046,S99999999,S99999999,00QS,Large City,2,50
5007,WSTIG,534,352,182,225,309,S12000035,S99999999,S99999999,00QD,"Below 1,000 (b)",13,10
5008,WSTIN,867,331,536,3,864,S12000029,S99999999,S99999999,00RF,"Below 1,000 (b)",13,10
5009,WSTIR,38,18,20,0,38,S12000035,S99999999,S99999999,00QD,"Below 1,000 (b)",13,10
5010,WSTOB,687,552,135,526,161,S12000017,S99999999,S99999999,00QT,"Below 1,000 (b)",13,10
5011,WSTOD,52,43,9,7,45,S12000006,S99999999,S99999999,00QH,"Below 1,000 (b)",13,10
5012,WSTOR,341,72,269,14,327,S12000008,S99999999,S99999999,00QK,"Below 1,000 (b)",13,10
5013,WSTOW,179,127,52,65,114,S12000035,S99999999,S99999999,00QD,"Below 1,000 (b)",13,10
5014,WSTRO,8190,5481,2709,2568,5622,S12000028,S99999999,S99999999,00RE,"Above 3,000 (a)",8,30
5015,WSTUR,294,129,165,82,212,S12000028,S99999999,S99999999,00RE,"Below 1,000 (b)",13,10
5016,WSTWE,104,0,104,0,104,S12000026,S99999999,S99999999,00QE,"Below 1,000 (b)",13,10
5017,WSTWY,311,224,87,166,145,S12000006,S99999999,S99999999,00QH,"Below 1,000 (b)",13,10
5018,WSTYN,128,82,46,82,46,S12000030,S99999999,S99999999,00RG,"Below 1,000 (a)",12,10
5019,WSUDD,9739,7900,1839,3646,6093,S12000029,S99999999,S99999999,00RF,"Above 3,000 (b)",9,10
5020,WSULV,61,17,44,0,61,S12000035,S99999999,S99999999,00QD,"Below 1,000 (b)",13,10
5021,WSUPL,573,296,277,260,313,S12000008,S99999999,S99999999,00QK,"Below 1,000 (a)",12,10
5022,WSWAT,215,90,125,60,155,S12000006,S99999999,S99999999,00QH,"Below 1,000 (b)",13,10
5023,WSWEK,2596,2445,151,2163,433,S12000021,S99999999,S99999999,00QY,"Above 1,000 (b)",11,10
5024,WSWEM,3649,1315,2334,949,2700,S12000021,S99999999,S99999999,00QY,"Above 3,000 (b)",9,10
5025,WSWES,22133,22058,75,12661,9472,S12000046,S99999999,S99999999,00QS,Large City,2,50
5026,WSWHB,548,504,44,288,260,S12000021,S99999999,S99999999,00QY,"Below 1,000 (a)",12,10
5027,WSWHH,877,495,382,462,415,S12000006,S99999999,S99999999,00QH,"Below 1,000 (b)",13,10
5028,WSWHI,94,56,38,40,54,S12000035,S99999999,S99999999,00QD,"Below 1,000 (b)",13,10
5029,WSWIG,708,638,70,538,170,S12000006,S99999999,S99999999,00QH,"Below 1,000 (b)",13,10
5030,WSWIS,12277,10016,2261,4792,7485,S12000029,S99999999,S99999999,00RF,"Above 10,000 (b)",7,30
5031,WWANST,419,127,292,54,365,E07000042,E10000008,E12000009,18,"Below 1,000 (b)",13,10
5032,WWASHB,1987,1823,164,785,1202,E07000045,E10000008,E12000009,18,"Above 1,000 (b)",11,10
5033,WWASHC,1023,739,284,354,669,E07000189,E10000027,E12000009,40,"Above 1,000 (b)",11,10
5034,WWASHR,512,135,377,86,426,E07000042,E10000008,E12000009,18,"Below 1,000 (b)",13,10
5035,WWASHW,671,208,463,150,521,E07000046,E10000008,E12000009,18,"Below 1,000 (b)",13,10
5036,WWAXMI,4551,3549,1002,2798,1753,E07000052,E10000009,E12000009,19,"Above 3,000 (b)",9,10
5037,WWBAMP,1127,757,370,666,461,E07000042,E10000008,E12000009,18,"Above 1,000 (b)",11,10
5038,WWBARN,16118,11049,5069,4509,11609,E07000043,E10000008,E12000009,18,"Above 10,000 (a)",6,30
5039,WWBAWT,527,278,249,48,479,E07000044,E10000008,E12000009,18,"Below 1,000 (b)",13,10
5040,WWBCAU,655,238,417,181,474,E07000050,E10000009,E12000009,19,"Below 1,000 (b)",13,10
5041,WWBCKL,439,169,270,58,381,E07000042,E10000008,E12000009,18,"Below 1,000 (b)",13,10
5042,WWBCKN,1145,249,896,107,1038,E07000045,E10000008,E12000009,18,"Above 1,000 (b)",11,10
5043,WWBCLY,314,122,192,67,247,E07000047,E10000008,E12000009,18,"Below 1,000 (b)",13,10
5044,WWBDON,180,71,109,35,145,E07000191,E10000027,E12000009,40,"Below 1,000 (b)",13,10
5045,WWBEAF,530,210,320,158,372,E07000046,E10000008,E12000009,18,"Below 1,000 (b)",13,10
5046,WWBEAW,894,417,477,302,592,E07000047,E10000008,E12000009,18,"Below 1,000 (b)",13,10
5047,WWBERE,2063,1314,749,1155,908,E07000047,E10000008,E12000009,18,"Above 1,000 (b)",11,10
5048,WWBFAS,2208,1884,324,1499,709,E07000045,E10000008,E12000009,18,"Above 1,000 (a)",10,10
5049,WWBIDE,14517,9751,4766,5063,9454,E07000043,E10000008,E12000009,18,"Above 10,000 (a)",6,30
5050,WWBIGB,804,385,419,31,773,E07000044,E10000008,E12000009,18,"Below 1,000 (b)",13,10
5051,WWBKNO,740,585,155,339,401,E07000188,E10000027,E12000009,40,"Below 1,000 (b)",13,10
5052,WWBLAG,823,347,476,191,632,E07000190,E10000027,E12000009,40,"Below 1,000 (b)",13,10
5053,WWBLYD,2522,2166,356,1008,1514,E07000190,E10000027,E12000009,40,"Above 1,000 (b)",11,10
5054,WWBNYM,672,271,401,12,660,E07000043,E10000008,E12000009,18,"Below 1,000 (b)",13,10
5055,WWBODM,7679,7279,400,4572,3107,E06000052,E99999999,E12000009,00HE,"Above 3,000 (b)",9,10
5056,WWBOSC,668,604,64,543,125,E06000052,E99999999,E12000009,00HE,"Below 1,000 (b)",13,10
5057,WWBOW,849,616,233,497,352,E07000042,E10000008,E12000009,18,"Below 1,000 (b)",13,10
5058,WWBRAN,463,301,162,174,289,E07000040,E10000008,E12000009,18,"Below 1,000 (b)",13,10
5059,WWBRAU,4929,4088,841,3019,1910,E07000043,E10000008,E12000009,18,"Above 3,000 (b)",9,10
5060,WWBRAY,788,63,725,9,779,E07000043,E10000008,E12000009,18,"Below 1,000 (b)",13,10
5061,WWBRDY,818,446,372,368,450,E07000046,E10000008,E12000009,18,"Below 1,000 (a)",12,10
5062,WWBREA,612,393,219,208,404,E07000188,E10000027,E12000009,40,"Below 1,000 (b)",13,10
5063,WWBRIX,9287,9019,268,6173,3114,E07000044,E10000008,E12000009,18,"Above 3,000 (b)",9,10
5064,WWBROA,374,195,179,97,277,E07000040,E10000008,E12000009,18,"Below 1,000 (a)",12,10
5065,WWBROM,372,31,341,5,367,E07000191,E10000027,E12000009,40,"Below 1,000 (b)",13,10
5066,WWBRUL,686,334,352,262,424,E07000046,E10000008,E12000009,18,"Below 1,000 (b)",13,10
5067,WWBSTM,784,263,521,83,701,E07000189,E10000027,E12000009,40,"Below 1,000 (b)",13,10
5068,WWBSTW,507,279,228,191,316,E07000047,E10000008,E12000009,18,"Below 1,000 (a)",12,10
5069,WWBTON,877,553,324,175,702,E07000190,E10000027,E12000009,40,"Below 1,000 (b)",13,10
5070,WWBTOR,502,216,286,136,366,E07000047,E10000008,E12000009,18,"Below 1,000 (b)",13,10
5071,WWBTRA,4089,2910,1179,1850,2239,E07000045,E10000008,E12000009,18,"Above 3,000 (b)",9,10
5072,WWBUDE,5505,5014,491,3334,2171,E06000052,E99999999,E12000009,00HE,"Above 3,000 (b)",9,10
5073,WWBUDL,3321,3040,281,2566,755,E07000040,E10000008,E12000009,18,"Above 3,000 (b)",9,10
5074,WWBURN,11803,8666,3137,4878,6925,E07000188,E10000027,E12000009,40,"Above 10,000 (b)",7,30
5075,WWBURR,1147,178,969,106,1041,E07000189,E10000027,E12000009,40,"Above 1,000 (b)",11,10
5076,WWBWAT,20486,17834,2652,6892,13594,E07000188,E10000027,E12000009,40,"Above 20,000 (b)",5,30
5077,WWCALL,3103,2620,483,2165,938,E06000052,E99999999,E12000009,00HE,"Above 3,000 (b)",9,10
5078,WWCAMB,11465,9343,2122,5594,5871,E06000052,E99999999,E12000009,00HE,"Above 10,000 (a)",6,30
5079,WWCAME,3080,1471,1609,1296,1784,E06000052,E99999999,E12000009,00HE,"Above 3,000 (b)",9,10
5080,WWCANW,507,235,272,68,439,E06000052,E99999999,E12000009,00HE,"Below 1,000 (b)",13,10
5081,WWCARD,648,219,429,85,563,E06000052,E99999999,E12000009,00HE,"Below 1,000 (b)",13,10
5082,WWCARY,2029,1749,280,1576,453,E07000189,E10000027,E12000009,40,"Above 1,000 (b)",11,10
5083,WWCBIS,445,284,161,181,264,E07000045,E10000008,E12000009,18,"Below 1,000 (b)",13,10
5084,WWCCKW,1455,859,596,529,926,E06000052,E99999999,E12000009,00HE,"Above 1,000 (b)",11,10
5085,WWCFIT,843,324,519,247,596,E07000042,E10000008,E12000009,18,"Below 1,000 (b)",13,10
5086,WWCHAG,974,759,215,634,340,E07000045,E10000008,E12000009,18,"Below 1,000 (b)",13,10
5087,WWCHEL,5596,5442,154,4022,1574,E06000027,E99999999,E12000009,00HH,"Above 3,000 (a)",8,30
5088,WWCHID,804,574,230,165,639,E07000052,E10000009,E12000009,19,"Below 1,000 (b)",13,10
5089,WWCHIS,1487,850,637,317,1170,E07000189,E10000027,E12000009,40,"Above 1,000 (b)",11,10
5090,WWCHIT,585,266,319,22,563,E07000043,E10000008,E12000009,18,"Below 1,000 (b)",13,10
5091,WWCHIV,372,219,153,35,337,E07000044,E10000008,E12000009,18,"Below 1,000 (b)",13,10
5092,WWCHLL,298,148,150,108,190,E07000047,E10000008,E12000009,18,"Below 1,000 (b)",13,10
5093,WWCHRD,7377,6721,656,5247,2130,E07000189,E10000027,E12000009,40,"Above 3,000 (a)",8,30
5094,WWCHRI,1033,499,534,62,971,E07000045,E10000008,E12000009,18,"Above 1,000 (b)",11,10
5095,WWCHRM,1147,1046,101,876,271,E07000052,E10000009,E12000009,19,"Above 1,000 (b)",11,10
5096,WWCHRS,4481,4142,339,2224,2257,E07000044,E10000008,E12000009,18,"Above 3,000 (b)",9,10
5097,WWCHUD,3170,2071,1099,1875,1295,E07000045,E10000008,E12000009,18,"Above 3,000 (b)",9,10
5098,WWCHUL,1213,669,544,583,630,E07000042,E10000008,E12000009,18,"Above 1,000 (b)",11,10
5099,WWCLAY,407,85,322,31,376,E07000042,E10000008,E12000009,18,"Below 1,000 (b)",13,10
5100,WWCLOV,747,226,521,146,601,E07000046,E10000008,E12000009,18,"Below 1,000 (b)",13,10
5101,WWCMAC,1138,576,562,340,798,E07000189,E10000027,E12000009,40,"Above 1,000 (b)",11,10
5102,WWCMAR,1887,1442,445,1096,791,E07000043,E10000008,E12000009,18,"Above 1,000 (b)",11,10
5103,WWCOAD,913,317,596,43,870,E06000052,E99999999,E12000009,00HE,"Below 1,000 (b)",13,10
5104,WWCOLY,2143,1550,593,1111,1032,E07000040,E10000008,E12000009,18,"Above 1,000 (b)",11,10
5105,WWCONS,993,664,329,486,507,E06000052,E99999999,E12000009,00HE,"Below 1,000 (b)",13,10
5106,WWCOPP,1135,646,489,505,630,E07000042,E10000008,E12000009,18,"Above 1,000 (b)",11,10
5107,WWCORN,942,441,501,318,624,E07000044,E10000008,E12000009,18,"Below 1,000 (b)",13,10
5108,WWCORS,667,147,520,38,629,E07000189,E10000027,E12000009,40,"Below 1,000 (b)",13,10
5109,WWCORT,508,177,331,23,485,E07000189,E10000027,E12000009,40,"Below 1,000 (a)",12,10
5110,WWCPOL,1448,841,607,331,1117,E07000188,E10000027,E12000009,40,"Above 1,000 (b)",11,10
5111,WWCRAD,1944,1287,657,779,1165,E07000042,E10000008,E12000009,18,"Above 1,000 (b)",11,10
5112,WWCRAL,1846,437,1409,216,1630,E07000040,E10000008,E12000009,18,"Above 1,000 (b)",11,10
5113,WWCRAN,2652,2008,644,464,2188,E06000052,E99999999,E12000009,00HE,"Above 1,000 (b)",11,10
5114,WWCRED,4710,4163,547,3169,1541,E07000042,E10000008,E12000009,18,"Above 3,000 (a)",8,30
5115,WWCREW,5888,4015,1873,3193,2695,E07000189,E10000027,E12000009,40,"Above 3,000 (b)",9,10
5116,WWCROY,1075,818,257,534,541,E07000043,E10000008,E12000009,18,"Above 1,000 (b)",11,10
5117,WWCRWC,271,205,66,131,140,E07000188,E10000027,E12000009,40,"Below 1,000 (b)",13,10
5118,WWCRWN,24252,18773,5479,5701,18551,E06000026,E99999999,E12000009,00HG,Small City,3,50
5119,WWCSTN,545,135,410,17,528,E07000040,E10000008,E12000009,18,"Below 1,000 (b)",13,10
5120,WWCULL,4544,4144,400,3689,855,E07000042,E10000008,E12000009,18,"Above 3,000 (a)",8,30
5121,WWCWIC,1569,1193,376,563,1006,E07000188,E10000027,E12000009,40,"Above 1,000 (b)",11,10
5122,WWDART,3622,3590,32,2699,923,E07000044,E10000008,E12000009,18,"Above 3,000 (a)",8,30
5123,WWDAWL,6818,6071,747,4113,2705,E07000045,E10000008,E12000009,18,"Above 3,000 (b)",9,10
5124,WWDITT,318,289,29,233,85,E07000044,E10000008,E12000009,18,"Below 1,000 (b)",13,10
5125,WWDOBW,1695,881,814,686,1009,E06000052,E99999999,E12000009,00HE,"Above 1,000 (a)",10,10
5126,WWDOLT,636,424,212,376,260,E07000047,E10000008,E12000009,18,"Below 1,000 (b)",13,10
5127,WWDOWN,745,699,46,464,281,E06000052,E99999999,E12000009,00HE,"Below 1,000 (b)",13,10
5128,WWDPRT,18550,18387,163,8733,9817,E06000052,E99999999,E12000009,00HE,"Above 10,000 (b)",7,30
5129,WWDRAN,3430,1649,1781,780,2650,E06000052,E99999999,E12000009,00HE,"Above 3,000 (b)",9,10
5130,WWDREW,335,172,163,103,232,E07000045,E10000008,E12000009,18,"Below 1,000 (b)",13,10
5131,WWDULV,1121,823,298,708,413,E07000042,E10000008,E12000009,18,"Above 1,000 (b)",11,10
5132,WWDUNS,1430,1027,403,382,1048,E07000191,E10000027,E12000009,40,"Above 1,000 (b)",11,10
5133,WWEALL,488,304,184,250,238,E07000044,E10000008,E12000009,18,"Below 1,000 (b)",13,10
5134,WWEVER,584,187,397,109,475,E07000052,E10000009,E12000009,19,"Below 1,000 (b)",13,10
5135,WWEXBO,450,247,203,149,301,E07000047,E10000008,E12000009,18,"Below 1,000 (b)",13,10
5136,WWEXFO,388,202,186,147,241,E07000191,E10000027,E12000009,40,"Below 1,000 (b)",13,10
5137,WWEXMN,4452,2202,2250,1283,3169,E07000041,E10000008,E12000009,18,"Above 3,000 (b)",9,10
5138,WWEXMO,17428,10698,6730,6097,11331,E07000040,E10000008,E12000009,18,"Above 10,000 (a)",6,30
5139,WWEXTR,36441,27189,9252,9316,27125,E07000040,E10000008,E12000009,18,"Above 20,000 (b)",5,30
5140,WWFALM,11633,11380,253,6312,5321,E06000052,E99999999,E12000009,00HE,"Above 10,000 (a)",6,30
5141,WWFARW,308,162,146,39,269,E07000040,E10000008,E12000009,18,"Below 1,000 (b)",13,10
5142,WWFENI,1468,1018,450,390,1078,E07000040,E10000008,E12000009,18,"Above 1,000 (b)",11,10
5143,WWFILL,276,95,181,22,254,E07000043,E10000008,E12000009,18,"Below 1,000 (b)",13,10
5144,WWFOWE,1942,1647,295,1440,502,E06000052,E99999999,E12000009,00HE,"Above 1,000 (b)",11,10
5145,WWFRAD,2114,1716,398,1126,988,E06000052,E99999999,E12000009,00HE,"Above 1,000 (b)",11,10
5146,WWFROG,723,441,282,185,538,E07000044,E10000008,E12000009,18,"Below 1,000 (b)",13,10
5147,WWGARA,555,88,467,23,532,E07000044,E10000008,E12000009,18,"Below 1,000 (b)",13,10
5148,WWGERM,1767,687,1080,441,1326,E06000052,E99999999,E12000009,00HE,"Above 1,000 (b)",11,10
5149,WWGHAM,1061,209,852,74,987,E07000042,E10000008,E12000009,18,"Above 1,000 (b)",11,10
5150,WWGRAM,2040,586,1454,51,1989,E06000052,E99999999,E12000009,00HE,"Above 1,000 (b)",11,10
5151,WWGUNN,2267,1574,693,983,1284,E07000047,E10000008,E12000009,18,"Above 1,000 (b)",11,10
5152,WWHARB,790,330,460,147,643,E07000044,E10000008,E12000009,18,"Below 1,000 (b)",13,10
5153,WWHART,876,637,239,509,367,E07000046,E10000008,E12000009,18,"Below 1,000 (b)",13,10
5154,WWHATH,1229,807,422,707,522,E07000047,E10000008,E12000009,18,"Above 1,000 (b)",11,10
5155,WWHAWK,563,244,319,148,415,E07000052,E10000009,E12000009,19,"Below 1,000 (b)",13,10
5156,WWHAYL,6539,4604,1935,2354,4185,E06000052,E99999999,E12000009,00HE,"Above 3,000 (b)",9,10
5157,WWHBCK,829,402,427,301,528,E07000043,E10000008,E12000009,18,"Below 1,000 (b)",13,10
5158,WWHBCM,1055,391,664,243,812,E07000189,E10000027,E12000009,40,"Above 1,000 (b)",11,10
5159,WWHCRX,949,277,672,120,829,E07000046,E10000008,E12000009,18,"Below 1,000 (b)",13,10
5160,WWHELE,1235,923,312,103,1132,E07000040,E10000008,E12000009,18,"Above 1,000 (b)",11,10
5161,WWHELS,8056,5422,2634,3352,4704,E06000052,E99999999,E12000009,00HE,"Above 3,000 (b)",9,10
5162,WWHEMY,1229,917,312,725,504,E07000040,E10000008,E12000009,18,"Above 1,000 (b)",11,10
5163,WWHENL,4646,2982,1664,623,4023,E07000190,E10000027,E12000009,40,"Above 3,000 (b)",9,10
5164,WWHOLB,382,250,132,175,207,E07000044,E10000008,E12000009,18,"Below 1,000 (b)",13,10
5165,WWHOLF,527,292,235,75,452,E07000191,E10000027,E12000009,40,"Below 1,000 (b)",13,10
5166,WWHOLN,604,115,489,17,587,E07000050,E10000009,E12000009,19,"Below 1,000 (b)",13,10
5167,WWHOLS,2410,1893,517,1627,783,E07000046,E10000008,E12000009,18,"Above 1,000 (b)",11,10
5168,WWHONI,6403,5902,501,4060,2343,E07000040,E10000008,E12000009,18,"Above 3,000 (a)",8,30
5169,WWHTOR,342,271,71,126,216,E07000045,E10000008,E12000009,18,"Below 1,000 (b)",13,10
5170,WWILCH,1480,1024,456,855,625,E07000189,E10000027,E12000009,40,"Above 1,000 (b)",11,10
5171,WWILFR,5601,5251,350,4078,1523,E07000043,E10000008,E12000009,18,"Above 3,000 (a)",8,30
5172,WWILMI,4751,3054,1697,2575,2176,E07000189,E10000027,E12000009,40,"Above 3,000 (b)",9,10
5173,WWINST,3862,1974,1888,522,3340,E07000043,E10000008,E12000009,18,"Above 3,000 (b)",9,10
5174,WWIPPL,1910,1238,672,1020,890,E07000045,E10000008,E12000009,18,"Above 1,000 (a)",10,10
5175,WWISLE,1129,159,970,48,1081,E07000189,E10000027,E12000009,40,"Above 1,000 (b)",11,10
5176,WWIVYB,6178,5243,935,3727,2451,E07000044,E10000008,E12000009,18,"Above 3,000 (a)",8,30
5177,WWKENN,930,549,381,281,649,E07000045,E10000008,E12000009,18,"Below 1,000 (b)",13,10
5178,WWKENT,553,397,156,252,301,E07000040,E10000008,E12000009,18,"Below 1,000 (b)",13,10
5179,WWKGWR,706,648,58,526,180,E07000044,E10000008,E12000009,18,"Below 1,000 (b)",13,10
5180,WWKILK,786,553,233,436,350,E07000046,E10000008,E12000009,18,"Below 1,000 (b)",13,10
5181,WWKKWL,3402,2841,561,1833,1569,E07000045,E10000008,E12000009,18,"Above 3,000 (b)",9,10
5182,WWKNGB,3864,3556,308,3009,855,E07000044,E10000008,E12000009,18,"Above 3,000 (a)",8,30
5183,WWKSTM,1189,531,658,237,952,E07000188,E10000027,E12000009,40,"Above 1,000 (b)",11,10
5184,WWLAND,1153,471,682,39,1114,E06000052,E99999999,E12000009,00HE,"Above 1,000 (b)",11,10
5185,WWLANR,956,240,716,166,790,E06000052,E99999999,E12000009,00HE,"Below 1,000 (a)",12,10
5186,WWLAPF,841,571,270,431,410,E07000042,E10000008,E12000009,18,"Below 1,000 (b)",13,10
5187,WWLAUN,6046,4963,1083,3300,2746,E07000047,E10000008,E12000009,18,"Above 3,000 (b)",9,10
5188,WWLDOW,623,206,417,105,518,E07000045,E10000008,E12000009,18,"Below 1,000 (b)",13,10
5189,WWLEED,1277,611,666,259,1018,E06000052,E99999999,E12000009,00HE,"Above 1,000 (b)",11,10
5190,WWLIFT,754,509,245,439,315,E07000047,E10000008,E12000009,18,"Below 1,000 (a)",12,10
5191,WWLISK,7385,5010,2375,4170,3215,E06000052,E99999999,E12000009,00HE,"Above 3,000 (a)",8,30
5192,WWLLAW,532,178,354,114,418,E07000190,E10000027,E12000009,40,"Below 1,000 (b)",13,10
5193,WWLODD,1075,608,467,458,617,E07000044,E10000008,E12000009,18,"Above 1,000 (b)",11,10
5194,WWLOOE,3651,3289,362,2009,1642,E06000052,E99999999,E12000009,00HE,"Above 3,000 (a)",8,30
5195,WWLOST,1990,1480,510,1343,647,E06000052,E99999999,E12000009,00HE,"Above 1,000 (a)",10,10
5196,WWLPRT,3494,1844,1650,1524,1970,E07000189,E10000027,E12000009,40,"Above 3,000 (b)",9,10
5197,WWLSTL,381,306,75,201,180,E07000045,E10000008,E12000009,18,"Below 1,000 (b)",13,10
5198,WWLSUT,648,401,247,244,404,E07000189,E10000027,E12000009,40,"Below 1,000 (b)",13,10
5199,WWLTRE,675,215,460,123,552,E07000046,E10000008,E12000009,18,"Below 1,000 (b)",13,10
5200,WWLUPP,1153,895,258,689,464,E07000040,E10000008,E12000009,18,"Above 1,000 (b)",11,10
5201,WWLVET,1094,499,595,391,703,E06000052,E99999999,E12000009,00HE,"Above 1,000 (b)",11,10
5202,WWLWDN,474,241,233,128,346,E07000047,E10000008,E12000009,18,"Below 1,000 (b)",13,10
5203,WWLYDF,258,166,92,111,147,E07000047,E10000008,E12000009,18,"Below 1,000 (a)",12,10
5204,WWLYME,3583,3079,504,2326,1257,E07000052,E10000009,E12000009,19,"Above 3,000 (a)",8,30
5205,WWLYNT,964,909,55,795,169,E07000043,E10000008,E12000009,18,"Below 1,000 (a)",12,10
5206,WWMABT,440,164,276,119,321,E07000047,E10000008,E12000009,18,"Below 1,000 (b)",13,10
5207,WWMARA,2313,1146,1167,818,1495,E06000052,E99999999,E12000009,00HE,"Above 1,000 (b)",11,10
5208,WWMARK,982,438,544,326,656,E07000188,E10000027,E12000009,40,"Below 1,000 (b)",13,10
5209,WWMART,4130,2719,1411,1500,2630,E07000189,E10000027,E12000009,40,"Above 3,000 (b)",9,10
5210,WWMAWG,777,338,439,169,608,E06000052,E99999999,E12000009,00HE,"Below 1,000 (a)",12,10
5211,WWMBSH,476,386,90,298,178,E07000042,E10000008,E12000009,18,"Below 1,000 (b)",13,10
5212,WWMCAN,630,426,204,106,524,E06000052,E99999999,E12000009,00HE,"Below 1,000 (b)",13,10
5213,WWMDAM,552,129,423,55,497,E07000046,E10000008,E12000009,18,"Below 1,000 (b)",13,10
5214,WWMEVA,2472,1441,1031,1353,1119,E06000052,E99999999,E12000009,00HE,"Above 1,000 (a)",10,10
5215,WWMILV,1280,678,602,547,733,E07000190,E10000027,E12000009,40,"Above 1,000 (b)",11,10
5216,WWMINE,5858,5799,59,4135,1723,E07000191,E10000027,E12000009,40,"Above 3,000 (a)",8,30
5217,WWMITC,996,175,821,132,864,E06000052,E99999999,E12000009,00HE,"Below 1,000 (b)",13,10
5218,WWMLBK,2030,1663,367,1032,998,E06000052,E99999999,E12000009,00HE,"Above 1,000 (a)",10,10
5219,WWMMAG,1308,427,881,196,1112,E07000189,E10000027,E12000009,40,"Above 1,000 (b)",11,10
5220,WWMODY,1107,785,322,719,388,E07000044,E10000008,E12000009,18,"Above 1,000 (b)",11,10
5221,WWMORT,970,797,173,720,250,E07000045,E10000008,E12000009,18,"Below 1,000 (a)",12,10
5222,WWMORW,530,238,292,116,414,E07000046,E10000008,E12000009,18,"Below 1,000 (b)",13,10
5223,WWMOUS,2238,2003,235,826,1412,E06000052,E99999999,E12000009,00HE,"Above 1,000 (b)",11,10
5224,WWMPRT,1627,1428,199,1339,288,E07000189,E10000027,E12000009,40,"Above 1,000 (b)",11,10
5225,WWMSMT,917,801,116,473,444,E06000052,E99999999,E12000009,00HE,"Below 1,000 (b)",13,10
5226,WWMTON,235,166,69,109,126,E07000045,E10000008,E12000009,18,"Below 1,000 (b)",13,10
5227,WWMTVY,740,412,328,314,426,E07000047,E10000008,E12000009,18,"Below 1,000 (b)",13,10
5228,WWMULL,1384,1082,302,750,634,E06000052,E99999999,E12000009,00HE,"Above 1,000 (b)",11,10
5229,WWNABB,18101,12179,5922,4817,13284,E07000045,E10000008,E12000009,18,"Above 10,000 (a)",6,30
5230,WWNANP,4120,2032,2088,322,3798,E06000052,E99999999,E12000009,00HE,"Above 3,000 (b)",9,10
5231,WWNCAD,877,394,483,104,773,E07000189,E10000027,E12000009,40,"Below 1,000 (b)",13,10
5232,WWNCUR,955,625,330,444,511,E07000189,E10000027,E12000009,40,"Below 1,000 (b)",13,10
5233,WWNCYR,767,377,390,227,540,E07000040,E10000008,E12000009,18,"Below 1,000 (b)",13,10
5234,WWNETH,1485,859,626,704,781,E07000188,E10000027,E12000009,40,"Above 1,000 (b)",11,10
5235,WWNEWQ,10611,9563,1048,3091,7520,E06000052,E99999999,E12000009,00HE,"Above 10,000 (a)",6,30
5236,WWNFER,1057,956,101,746,311,E07000044,E10000008,E12000009,18,"Above 1,000 (a)",10,10
5237,WWNMOL,547,63,484,25,522,E07000191,E10000027,E12000009,40,"Below 1,000 (b)",13,10
5238,WWNPTN,2887,2306,581,1516,1371,E07000188,E10000027,E12000009,40,"Above 1,000 (b)",11,10
5239,WWNPWI,830,187,643,164,666,E07000046,E10000008,E12000009,18,"Below 1,000 (b)",13,10
5240,WWNTAM,370,94,276,56,314,E07000046,E10000008,E12000009,18,"Below 1,000 (b)",13,10
5241,WWNTAW,1080,886,194,824,256,E07000042,E10000008,E12000009,18,"Above 1,000 (b)",11,10
5242,WWNTCY,678,171,507,116,562,E07000043,E10000008,E12000009,18,"Below 1,000 (b)",13,10
5243,WWOAKF,389,161,228,83,306,E07000042,E10000008,E12000009,18,"Below 1,000 (a)",12,10
5244,WWOKEH,4653,4186,467,1997,2656,E07000047,E10000008,E12000009,18,"Above 3,000 (b)",9,10
5245,WWOSMY,3408,2645,763,2299,1109,E07000040,E10000008,E12000009,18,"Above 3,000 (b)",9,10
5246,WWOSTN,573,179,394,60,513,E06000052,E99999999,E12000009,00HE,"Below 1,000 (b)",13,10
5247,WWPADS,2223,1907,316,1597,626,E06000052,E99999999,E12000009,00HE,"Above 1,000 (b)",11,10
5248,WWPAIG,19623,17288,2335,7966,11657,E07000044,E10000008,E12000009,18,"Above 10,000 (b)",7,30
5249,WWPAR,5482,4332,1150,2732,2750,E06000052,E99999999,E12000009,00HE,"Above 3,000 (b)",9,10
5250,WWPCMB,439,143,296,118,321,E07000191,E10000027,E12000009,40,"Below 1,000 (b)",13,10
5251,WWPENZ,10459,9470,989,5295,5164,E06000052,E99999999,E12000009,00HE,"Above 10,000 (a)",6,30
5252,WWPERR,2543,2000,543,1599,944,E06000052,E99999999,E12000009,00HE,"Above 1,000 (b)",11,10
5253,WWPINH,7532,4522,3010,2398,5134,E07000040,E10000008,E12000009,18,"Above 3,000 (a)",8,30
5254,WWPIPE,925,265,660,23,902,E06000052,E99999999,E12000009,00HE,"Below 1,000 (b)",13,10
5255,WWPISA,1072,804,268,657,415,E06000052,E99999999,E12000009,00HE,"Above 1,000 (b)",11,10
5256,WWPLRN,626,586,40,575,51,E06000052,E99999999,E12000009,00HE,"Below 1,000 (a)",12,10
5257,WWPOLP,1068,882,186,704,364,E06000052,E99999999,E12000009,00HE,"Above 1,000 (b)",11,10
5258,WWPORL,1175,963,212,757,418,E07000191,E10000027,E12000009,40,"Above 1,000 (a)",10,10
5259,WWPOST,100,58,42,38,62,E07000045,E10000008,E12000009,18,"Below 1,000 (b)",13,10
5260,WWPOUN,341,126,215,55,286,E07000045,E10000008,E12000009,18,"Below 1,000 (b)",13,10
5261,WWPRAZ,1152,583,569,456,696,E06000052,E99999999,E12000009,00HE,"Above 1,000 (b)",11,10
5262,WWPREA,3182,1954,1228,336,2846,E06000052,E99999999,E12000009,00HE,"Above 3,000 (b)",9,10
5263,WWPRIN,456,398,58,384,72,E07000047,E10000008,E12000009,18,"Below 1,000 (a)",12,10
5264,WWPRYN,5930,4430,1500,2962,2968,E06000052,E99999999,E12000009,00HE,"Above 3,000 (a)",8,30
5265,WWPSCO,794,625,169,507,287,E06000052,E99999999,E12000009,00HE,"Below 1,000 (a)",12,10
5266,WWPSTK,12091,10227,1864,4075,8016,E06000026,E99999999,E12000009,00HG,Small City,3,50
5267,WWPTON,13579,12425,1154,4728,8851,E06000026,E99999999,E12000009,00HG,Small City,3,50
5268,WWPTRE,634,336,298,189,445,E07000040,E10000008,E12000009,18,"Below 1,000 (b)",13,10
5269,WWPTWN,1630,708,922,367,1263,E06000052,E99999999,E12000009,00HE,"Above 1,000 (b)",11,10
5270,WWPURI,3314,1019,2295,806,2508,E07000188,E10000027,E12000009,40,"Above 3,000 (b)",9,10
5271,WWPYTH,21884,20345,1539,9247,12637,E06000026,E99999999,E12000009,00HG,Small City,3,50
5272,WWRACK,388,138,250,81,307,E07000042,E10000008,E12000009,18,"Below 1,000 (b)",13,10
5273,WWREDR,11324,7588,3736,4615,6709,E06000052,E99999999,E12000009,00HE,"Above 10,000 (a)",6,30
5274,WWRILL,1950,311,1639,21,1929,E06000052,E99999999,E12000009,00HE,"Above 1,000 (b)",11,10
5275,WWROBO,13975,10224,3751,3754,10221,E06000026,E99999999,E12000009,00HG,Small City,3,50
5276,WWROCH,1797,1439,358,1181,616,E06000052,E99999999,E12000009,00HE,"Above 1,000 (b)",11,10
5277,WWRUMF,917,514,403,79,838,E06000052,E99999999,E12000009,00HE,"Below 1,000 (b)",13,10
5278,WWSAGN,2156,1939,217,1534,622,E06000052,E99999999,E12000009,00HE,"Above 1,000 (b)",11,10
5279,WWSALC,2560,2094,466,1829,731,E07000044,E10000008,E12000009,18,"Above 1,000 (b)",11,10
5280,WWSALT,7920,7225,695,3944,3976,E06000052,E99999999,E12000009,00HE,"Above 3,000 (a)",8,30
5281,WWSAMP,2539,845,1694,120,2419,E07000042,E10000008,E12000009,18,"Above 1,000 (b)",11,10
5282,WWSAUS,13731,10115,3616,4307,9424,E06000052,E99999999,E12000009,00HE,"Above 10,000 (a)",6,30
5283,WWSBNT,1854,1300,554,1170,684,E07000044,E10000008,E12000009,18,"Above 1,000 (b)",11,10
5284,WWSBUD,13452,11219,2233,4096,9356,E07000047,E10000008,E12000009,18,"Above 10,000 (b)",7,30
5285,WWSBUR,882,435,447,360,522,E06000052,E99999999,E12000009,00HE,"Below 1,000 (b)",13,10
5286,WWSCAN,729,643,86,286,443,E07000040,E10000008,E12000009,18,"Below 1,000 (b)",13,10
5287,WWSCHD,1608,1322,286,819,789,E07000189,E10000027,E12000009,40,"Above 1,000 (b)",11,10
5288,WWSCIL,1373,924,449,131,1242,E06000053,E99999999,E12000009,00HF,"Above 1,000 (b)",11,10
5289,WWSCLM,956,394,562,183,773,E07000047,E10000008,E12000009,18,"Below 1,000 (b)",13,10
5290,WWSCOL,2180,1896,284,1633,547,E06000052,E99999999,E12000009,00HE,"Above 1,000 (b)",11,10
5291,WWSDAY,2699,1902,797,825,1874,E06000052,E99999999,E12000009,00HE,"Above 1,000 (b)",11,10
5292,WWSDOM,1202,576,626,270,932,E06000052,E99999999,E12000009,00HE,"Above 1,000 (a)",10,10
5293,WWSEAT,5231,4894,337,2737,2494,E07000040,E10000008,E12000009,18,"Above 3,000 (b)",9,10
5294,WWSENN,884,619,265,467,417,E06000052,E99999999,E12000009,00HE,"Below 1,000 (b)",13,10
5295,WWSFLM,906,606,300,472,434,E07000044,E10000008,E12000009,18,"Below 1,000 (b)",13,10
5296,WWSGAB,1143,719,424,572,571,E07000044,E10000008,E12000009,18,"Above 1,000 (a)",10,10
5297,WWSGEN,653,359,294,125,528,E06000052,E99999999,E12000009,00HE,"Below 1,000 (b)",13,10
5298,WWSGER,885,458,427,334,551,E06000052,E99999999,E12000009,00HE,"Below 1,000 (b)",13,10
5299,WWSHAL,2769,1217,1552,1077,1692,E07000045,E10000008,E12000009,18,"Above 1,000 (b)",11,10
5300,WWSHAU,429,165,264,85,344,E07000047,E10000008,E12000009,18,"Below 1,000 (b)",13,10
5301,WWSHEB,664,347,317,242,422,E07000046,E10000008,E12000009,18,"Below 1,000 (b)",13,10
5302,WWSHER,5275,4977,298,3533,1742,E07000052,E10000009,E12000009,19,"Above 3,000 (a)",8,30
5303,WWSHIP,5634,5447,187,4034,1600,E07000045,E10000008,E12000009,18,"Above 3,000 (b)",9,10
5304,WWSHIR,699,150,549,18,681,E07000043,E10000008,E12000009,18,"Below 1,000 (b)",13,10
5305,WWSIDB,1632,1500,132,382,1250,E07000040,E10000008,E12000009,18,"Above 1,000 (a)",10,10
5306,WWSIDM,6460,6231,229,3583,2877,E07000040,E10000008,E12000009,18,"Above 3,000 (b)",9,10
5307,WWSILV,1369,628,741,48,1321,E07000040,E10000008,E12000009,18,"Above 1,000 (a)",10,10
5308,WWSIVE,7053,5254,1799,4371,2682,E06000052,E99999999,E12000009,00HE,"Above 3,000 (b)",9,10
5309,WWSJUS,2851,1705,1146,1356,1495,E06000052,E99999999,E12000009,00HE,"Above 1,000 (a)",10,10
5310,WWSKEV,1122,559,563,427,695,E06000052,E99999999,E12000009,00HE,"Above 1,000 (a)",10,10
5311,WWSMAB,722,308,414,217,505,E06000052,E99999999,E12000009,00HE,"Below 1,000 (b)",13,10
5312,WWSMAR,12432,11520,912,7214,5218,E07000045,E10000008,E12000009,18,"Above 10,000 (b)",7,30
5313,WWSMER,1593,1172,421,509,1084,E06000052,E99999999,E12000009,00HE,"Above 1,000 (b)",11,10
5314,WWSMOL,2918,2747,171,2382,536,E07000043,E10000008,E12000009,18,"Above 1,000 (b)",11,10
5315,WWSMWG,810,470,340,137,673,E06000052,E99999999,E12000009,00HE,"Below 1,000 (b)",13,10
5316,WWSMWS,862,817,45,713,149,E06000052,E99999999,E12000009,00HE,"Below 1,000 (b)",13,10
5317,WWSOME,2542,2345,197,1423,1119,E07000189,E10000027,E12000009,40,"Above 1,000 (b)",11,10
5318,WWSOWT,8867,7035,1832,915,7952,E07000040,E10000008,E12000009,18,"Above 3,000 (b)",9,10
5319,WWSPAX,641,339,302,253,388,E07000188,E10000027,E12000009,40,"Below 1,000 (b)",13,10
5320,WWSPET,2797,1770,1027,1378,1419,E07000189,E10000027,E12000009,40,"Above 1,000 (b)",11,10
5321,WWSTAL,2082,1333,749,1140,942,E07000189,E10000027,E12000009,40,"Above 1,000 (b)",11,10
5322,WWSTAR,2556,1416,1140,816,1740,E07000040,E10000008,E12000009,18,"Above 1,000 (b)",11,10
5323,WWSTAV,1238,519,719,218,1020,E07000045,E10000008,E12000009,18,"Above 1,000 (b)",11,10
5324,WWSTEN,2892,2076,816,427,2465,E06000052,E99999999,E12000009,00HE,"Above 1,000 (b)",11,10
5325,WWSTIC,808,688,120,538,270,E07000047,E10000008,E12000009,18,"Below 1,000 (b)",13,10
5326,WWSTIT,2435,764,1671,589,1846,E06000052,E99999999,E12000009,00HE,"Above 1,000 (b)",11,10
5327,WWSTOC,591,178,413,17,574,E07000189,E10000027,E12000009,40,"Below 1,000 (b)",13,10
5328,WWSTOG,610,308,302,237,373,E07000191,E10000027,E12000009,40,"Below 1,000 (b)",13,10
5329,WWSTUD,1273,343,930,96,1177,E06000052,E99999999,E12000009,00HE,"Above 1,000 (a)",10,10
5330,WWSUTT,1759,292,1467,138,1621,E07000044,E10000008,E12000009,18,"Above 1,000 (b)",11,10
5331,WWSWIM,1831,1088,743,384,1447,E07000043,E10000008,E12000009,18,"Above 1,000 (b)",11,10
5332,WWTAUN,28041,19217,8824,6526,21515,E07000190,E10000027,E12000009,40,"Above 20,000 (a)",4,30
5333,WWTAVI,6848,6276,572,4161,2687,E07000047,E10000008,E12000009,18,"Above 3,000 (a)",8,30
5334,WWTEDB,863,549,314,332,531,E07000045,E10000008,E12000009,18,"Below 1,000 (b)",13,10
5335,WWTEIG,7755,7665,90,4787,2968,E07000045,E10000008,E12000009,18,"Above 3,000 (b)",9,10
5336,WWTEMP,1320,941,379,716,604,E07000189,E10000027,E12000009,40,"Above 1,000 (a)",10,10
5337,WWTHRE,2568,1249,1319,129,2439,E06000052,E99999999,E12000009,00HE,"Above 1,000 (b)",11,10
5338,WWTIMB,641,251,390,28,613,E07000191,E10000027,E12000009,40,"Below 1,000 (b)",13,10
5339,WWTINT,1209,1016,193,658,551,E06000052,E99999999,E12000009,00HE,"Above 1,000 (b)",11,10
5340,WWTIVE,10265,9496,769,4836,5429,E07000042,E10000008,E12000009,18,"Above 10,000 (b)",7,30
5341,WWTLIZ,1175,485,690,317,858,E06000052,E99999999,E12000009,00HE,"Above 1,000 (b)",11,10
5342,WWTOPS,4048,3453,595,1967,2081,E07000040,E10000008,E12000009,18,"Above 3,000 (b)",9,10
5343,WWTORQ,10305,9922,383,6717,3588,E06000027,E99999999,E12000009,00HH,"Above 10,000 (a)",6,30
5344,WWTORR,3355,2783,572,2334,1021,E07000046,E10000008,E12000009,18,"Above 3,000 (b)",9,10
5345,WWTORX,1279,830,449,347,932,E07000044,E10000008,E12000009,18,"Above 1,000 (b)",11,10
5346,WWTOTN,5569,4989,580,3710,1859,E07000044,E10000008,E12000009,18,"Above 3,000 (a)",8,30
5347,WWTPNT,3954,3867,87,3083,871,E06000052,E99999999,E12000009,00HE,"Above 3,000 (b)",9,10
5348,WWTREB,1772,896,876,611,1161,E06000052,E99999999,E12000009,00HE,"Above 1,000 (b)",11,10
5349,WWTREG,782,558,224,227,555,E06000052,E99999999,E12000009,00HE,"Below 1,000 (b)",13,10
5350,WWTRES,645,403,242,350,295,E06000052,E99999999,E12000009,00HE,"Below 1,000 (b)",13,10
5351,WWTRUR,11873,9780,2093,5611,6262,E06000052,E99999999,E12000009,00HE,"Above 10,000 (a)",6,30
5352,WWUPOT,582,201,381,17,565,E07000040,E10000008,E12000009,18,"Below 1,000 (b)",13,10
5353,WWVERY,770,410,360,232,538,E06000052,E99999999,E12000009,00HE,"Below 1,000 (b)",13,10
5354,WWWADE,4294,3775,519,2851,1443,E06000052,E99999999,E12000009,00HE,"Above 3,000 (a)",8,30
5355,WWWASH,1183,717,466,185,998,E07000191,E10000027,E12000009,40,"Above 1,000 (b)",11,10
5356,WWWBAY,672,333,339,259,413,E06000052,E99999999,E12000009,00HE,"Below 1,000 (a)",12,10
5357,WWWCKR,2414,1310,1104,613,1801,E07000189,E10000027,E12000009,40,"Above 1,000 (b)",11,10
5358,WWWDGT,700,333,367,178,522,E06000052,E99999999,E12000009,00HE,"Below 1,000 (b)",13,10
5359,WWWDWN,485,165,320,89,396,E07000042,E10000008,E12000009,18,"Below 1,000 (b)",13,10
5360,WWWEEK,611,262,349,222,389,E06000052,E99999999,E12000009,00HE,"Below 1,000 (b)",13,10
5361,WWWELL,8053,7574,479,4831,3222,E07000190,E10000027,E12000009,40,"Above 3,000 (b)",9,10
5362,WWWEMB,1403,1163,240,803,600,E06000026,E99999999,E12000009,00HG,"Above 1,000 (b)",11,10
5363,WWWFRD,306,167,139,100,206,E07000191,E10000027,E12000009,40,"Below 1,000 (b)",13,10
5364,WWWHEA,484,209,275,53,431,E07000189,E10000027,E12000009,40,"Below 1,000 (b)",13,10
5365,WWWHIM,2679,810,1869,123,2556,E07000040,E10000008,E12000009,18,"Above 1,000 (b)",11,10
5366,WWWILL,3848,2758,1090,1347,2501,E07000191,E10000027,E12000009,40,"Above 3,000 (b)",9,10
5367,WWWILM,628,247,381,140,488,E07000040,E10000008,E12000009,18,"Below 1,000 (b)",13,10
5368,WWWINC,3735,3209,526,2798,937,E07000189,E10000027,E12000009,40,"Above 3,000 (b)",9,10
5369,WWWITH,1142,653,489,584,558,E07000042,E10000008,E12000009,18,"Above 1,000 (a)",10,10
5370,WWWIVE,1708,1363,345,1156,552,E07000190,E10000027,E12000009,40,"Above 1,000 (b)",11,10
5371,WWWKLH,981,671,310,584,397,E07000042,E10000008,E12000009,18,"Below 1,000 (b)",13,10
5372,WWWMON,2531,1801,730,149,2382,E07000188,E10000027,E12000009,40,"Above 1,000 (b)",11,10
5373,WWWMOR,174,97,77,58,116,E07000045,E10000008,E12000009,18,"Below 1,000 (b)",13,10
5374,WWWOOD,1770,1209,561,260,1510,E07000040,E10000008,E12000009,18,"Above 1,000 (b)",11,10
5375,WWWOOL,1333,1032,301,674,659,E07000043,E10000008,E12000009,18,"Above 1,000 (b)",11,10
5376,WWWSHM,846,389,457,289,557,E07000189,E10000027,E12000009,40,"Below 1,000 (b)",13,10
5377,WWWZOY,1212,807,405,704,508,E07000188,E10000027,E12000009,40,"Above 1,000 (b)",11,10
5378,WWYEAL,1679,1075,604,864,815,E07000044,E10000008,E12000009,18,"Above 1,000 (b)",11,10
5379,WWYELV,3370,1774,1596,715,2655,E07000047,E10000008,E12000009,18,"Above 3,000 (a)",8,30
5380,WWYEOV,23229,15664,7565,4926,18303,E07000189,E10000027,E12000009,40,"Above 20,000 (a)",4,30
5381,WWYETM,1698,653,1045,461,1237,E07000189,E10000027,E12000009,40,"Above 1,000 (b)",11,10
5382,WWZELA,1115,180,935,102,1013,E06000052,E99999999,E12000009,00HE,"Above 1,000 (b)",11,10
